01000001110000101100001100011100010100001000010000100000000011001011011010000000000110000111110000011
00110001000001011000110010000011000100010000110001000001000000101000000000100001001110010100001000100
00000010000101111001110001000100000000111001110000011000111100001100001001001000000000010000000010000
00000000010100100000100100010001101000100000001001010101010001011000001010010000000101100000000001010
11001010101000000100110010011001000101011000001000001000000101001100100000101101001100010000010000010
10110000100000001000011000010000100110010000100101001000010001100010000100000101000010000111100000000
00000000000000100000010010000000100010000000000010101100000001101010000101001000111000011110001100000
10000100000011000101011110000010000111000001001101110100000001110001000000110000000000110000101101001
00000100000000000000101000110000011011000000000100000110000010010110000000001110001000100000101000111
00010001011000100110101100000000100001001000000010010000100110000000011000000000010011000000001001100
00000010011100000100000000100100011000011000011111000000100001010110111110000110001000000100110000010
01000101001100100000000001101001011011000111000010000100000001000100100000101000100000000100001001111
00100000010100001110000100010011010110000000100111000000001001000000010001101000100000000010010001000
00000101101001000010000101000100100001000001000001011101010100000000001110010101000011001001000100011
00100001011010000011000101000100100100100010001000000100001000000100100111110101000110000001000000000
00000101000010111010000100100101000000110010010000011101000001011101110100000000010000000000010010101
00100010100001000100000010000110011100010000011101110000000000000000000010001000010001001101100100000
00000000010101001000101010011010011100101001001010010101010110000101011101010100011110000000100010110
01001000001100100010000001000000000001000100100011001011100000110100101010000001000010100000010001000
10110000100000100100011100100010100001011000001001101001000111000000101101110101101011011111100000100
01000010011001100000000000001000100000000100000011001000000110100000000000010000010000011010100001000
01010110111000100001101111010000000000101001100001010011011010001001000101111010010100000110110001100
00100001000010010000100000010001100000011111000010000011000000100101000110000001011000110101100000000
00010010010111110000110100100011100100000010001111000010001010010110000011001010101000101100010000000
10000000000000000000110011000100100101000111000001110010010010001101100110000000100000011000000000011
10100000010000011010100011100001001001110000010110001000000000010001100010000010001010000010000001010
00001011000010100100001000010000000000101000000010010010010010000100100000110001000100101001000000100
11001001100000010010001100011000000010000100011100001010101100010011000010000010101000101000000110100
10010010001010010100011110010001001000110000000100010001000001000001000000000100000000000010001010100
10100000010000000101010110011000100000100000100010110001001001011100011100001010000111100000000001001
00000001000000000000101111000000000101011100000000001000100011101000000010111000100001010000000000001
00010100000100101000100000001010011000110000110010000111100010110011101010010001001100100001110010010
01000001011100101111110000011001000000000000100010000001010001000100010100001001101010000000010011000
00001100011000010101010000000100100101100001001000010000100000000000010000010010011010100010100101000
00000001001000010011110100001000000001000001110000010010011101000010000000001001111000001000000000000
00000001101000100000100100110000010001100000000001000010011000100000100010101001000010011000010000000
00101100010100011011010000000000000000001000100010100001001101010001001000000100000001100010000010010
01000000001100100100100011010000110100000000000000000001010100100001001010100000000000001001001101001
10000010001101000000000001110101001001110000010000100000100001110000100010000101100100010101010010000
10111000001000101000010000010100001000011000000000011010001000001111000000000001000011100100000000000
10101000001001000010000100000000110000000000100001010001100010101101110110000001110000100001111000000
10101001000100100010001100000000111001000100010111000010100101001000000000011111000000000101000100000
01011000010010010101001000000000001100000010010000000010001001001001100100010000100101000000000000100
00000100000000111000000010010010110101001010101101001000000101000000000001010010110001100100001010001
00000101001001001000000101101000000001001100010010000000000000010100000001000000110100000110000101010
10000101101101110001000000010100001011001000000010110101001010000000001000001111010011001100000000001
01000001000001001010001011000000010001000011000000000010000001100000101100001111000101000000100011000
00000001000100010000100001010001000000001001001001100001010100001001100001110010100000000011110000100
10101100111110011000000001000000000000000000101111001011000100010000000110010001100001000100000110101
10011010000010010000000000000111001010011100000000011001001001000101000000101000000011101000001000110
00000000001010000011011001100100001001000000000000100000110000110000011001000001000000110001000000010
00110001110001000001110100010000000000101000000001010011000000010100101101001000010011001001010000100
11000000001000010001000000100010001000001100110000001110010100100000011001000010010010001010000100100
00000000000000110101000001110000111010000010001000011010111010000100001011000010100000000000001010100
11000000000010000010001001001000000000001000010000001000001101001010001111110100011000000000100110010
10000010001000001000100010000001001011100000101100000001001100001000110010100000001011110000000100000
00010100100000001100010011000000001000000110001000000000000101111001001000001100010101010000000010000
00000111100101000000010000011000001000100000000011000001000010000101000010101100001010010000100001111
10010100100001001000101010100100010011101000000100100000001001100000100000000111000110000010000100000
01000001000000000001001001011010010010000101011001010001100010011000001100110000000100010010010101101
00011110110001000100110000001000001101100000000000111101001100110000011100100000000100100010000000000
10100101001000000001000000001000100000000010000011001000011000000000000001111100100011100100100000000
11110000110101011110100110000010011110011100010001001110101001000000010000100110000010110000010000001
00001000001000001001110111000001001001000101001101000000000100111010000000001100000001000000100010001
00100000000010101010100001010000000100100000001000000010101100000011101000000000000100000010000010000
10111001001000000000000000000110000010101000000001000000010100000010000010110000010000100010100000000
00000001000000011101000000100000001001101100000010000110110000101111010110100000101000001011111011111
11101000110100001000100100100100000110110010000000100010100001010000000011100101010000010010100011000
01100001010101000001000000110001001010110000100000001100000001000100110010000100100000000000000001000
00011101000010100110000100011110001011000100000000101001000111000000100001000000000000100100001001011
00001000010000100010011001111110001001001001000010001100111000110001100001010010010110000001000001000
10001001100001101110101010100001100010000101100010001100000100011010100010000100100000100010100010001
00100100010000000010101001010000101100000111000000110100001000001100000010100010000000000010011100010
10010010001000001100000000000100001000000010001000000010100010000000000001101000000000010110001001000
00010000001101001000111000100001010110010100011010111100010001000000011010111100100000000001000100000
00100001001000000001010001000101000001110000000001000100011100110001101110001000000010001000000011011
00010100010000000100000000100001000010001010000010011100000000110100110100011010001000100000110000101
00101101010000101100101000000100000010010010001011000000001101000100001010000100100011011100000100110
01010010100011010101000100000100000000000000000001000001000101000001001010000100101000010000101001100
10110000000000000100001100110000100000100000001001100100001101000100110000100110000001000011101010111
10010011100001110000000100100100001000110100000110010000001010000101001110001100010000001000010110010
00000100000000001010000011001010000000000000001100010010000010001000000000000010000011001101100000000
01010110010100011000000001010010101010010100001001100000000000100001111110000100010001001000101111110
00100100100000001101001100001000000000010000001000001010000110000001111000000101000010010100001011001
11100000001001010100100000000000101001010000110100010100000100000000011000000110001110001000010111000
00000100101001100000010010000000100100010001011001100000000000001001010001111000000101000010101001010
11101000111000000010000011100100110100110000000100010111100110100110000101010100110000010000010000000
10110001010000011000001101100100100110000001010010000010001000000110000100011000000000100000011000000
01000000101001000100101100000010000001011100001000001110010000000010000111001101001010010001000001100
00100000100001010101100011110100010011011100010010000001101000011100011000011000011100000000010110011
01001000001000110010000011001000011010100100001010000101000000111010000001011010101100000000110010000
01011010001011100110000010000000000000001001100000010000010010000000000100100101001000010001000100101
00000000100010001000000000000101001000010100000000001001010010000001101100001100110000010101000100100
00001000100110000100101000000110010000100100011110010000000010001000100010000000100010100100010000001
00000100000001000001110100101011110011000100001010000001110010011010101110000000010000000000100010110
11100011001000010000111010000000000010001010000000001100000001100000000100010000000000011001110000010
01000001111000000100000001000100001010101101000000000010100000101000011101010100100000100000011010100
10011000110001100100000110010000001101001010000000000001001000100000100100000010001011101001010100000
00000001000000101001001000000000010000101111101000000010000100011110010010100110000010111000101110001
00010001000100100100000000001000000000000100100011100110011010100000001010011100000100000010101000001
00000000000010100100000000001000000010000000001100001000001010010000001110100000101001001001010000000
