00110100000011010101001110100000000000100000101000100010100000000011010011000000001001101001101000100
01100111100000100110001110010000100101110100000111100000110010010001010001001100101000000000100000100
00000000001000000010110010011010000001000000010010110000000101010000000010000100000010010000110010000
01010011000000000001000001000100000101010000000010001000001001011100000001011000000010100000000000010
10010010010001001000010001011100010001010000000010000000000001101100101010110111110101010010101000000
00010001100000100000100001000111101010101100010000000001001100010000010000101101000001100000000110000
01000100100101110000101010000000000000010100000000110101001000001000001010110110010111010100001010011
01000000111000111000011010000000100100001000001100011000010110111000000010111100001000010001011000010
00100000000000011110000100111000110110000001100001100000001110001001010000010001001111010101010000110
00000110000101010001000100000010000101100000010010000110001100000001001010010000010000111000100011011
00000000010000100010000000001011000000010010001101100000001111111000001110010000010111000000101001000
00010011000001000000001000100010101100100010000100110000010100011000001000000000001000101111000110101
00000101010100000000000000100000000110000001011000001000000000000000010000010000100110000010000110100
10000001000001000000010001001000000100110101000000000110101000001100100001011000010110011010000000011
11010010010000001011010001001000010000001100101010010100100111000110000100000100100100001101000000000
11011111100000001011000101111100110110010000001100010000001100110001000100000110001100001010100001001
11001000011010000010000000000110100100000111111010101001000011111000111100001010111000000011101001010
01000010001000101100010001000100001100100001110011000011001110000100000000000000001001100010100010001
00000010000000011000100000000110001100000010010001000110000101000100100100110010100010000000001010000
10010000101000000010001000110000000000000000010001000100100100001000110010000001110101000100001001001
10000000011000001000000000100100000001001011000111000010010001100100010000000001110010101000000010010
00010000000000000000001100001000000000001011000010011100110100001000001000110010000000101000010000101
00000001100100010010000100101110011001100001010011000110001000000010100001000011101001011000000000110
11110100101001000010000001100010011000000000010100000000111100110100000010011101010010001100001000010
00010000010100000000100000000100000001100101001010000010111001010011100100110001100100001001001000000
10000100000011111100000100001010011100101000001110000100000010001000011001000000010000010010011100011
00010000001011010010100110000000000100010100101000011001011100100011000010000010010000010000110000000
00101000001100100000100101001011000011001011001000100000100011010000000101001010000001000000001101101
10000000000110011000011000000100110011001000101000111001000000100100010001100000000001100100011010001
11000000100000110010011000001100010000000000110110000100100000010000100010001010000101000011001001110
11001000001100100110000011000000111000000010000100010000000010000001001001000100000100011000100101110
10010110001001100010000100000001110110100010001000010010010111001001000101100100010000000000100101000
00110100000101111010010110000001001100100100000101010000000000100100001000000110001000111101010101101
00001011001011100000000000100001110001000100100000000001000000100110100110100010010000100000100100000
00000000000010001110000100011001000101001101110111100101000010000000001011001100101010000010000000000
00011010000000110011100000000001010000001101100000000001000001011000100000010011001011000010010110000
01100100010000001001011100100111101000100000000100000010010010101100100000110100000000000010100010100
11010100010000001001111000101000011001000101000000010000000100100000100001011111000100011110110000000
00011101001010010000001000000111010010001001011100000101111110110001010000101000001010000010000110000
00100100100011010010000000001001000000101110011000000001011001100000000110111010000010000101001001001
00000010010000010000000000001001000010000101001000011000001101001001000000010000001000011111000000010
01000010101010001000000000000100000000100100011111110001100010100110101000100010000000001000001000000
10101100000000101000100000100111000010101100001100100110010000011001100010000101000110000100010001000
10100001011100000100100000100010001000010000100001000000011000010100000100110010001000000110010000110
00000100000000110001001100010010010000010010001011001100000100001000000010101101001110100000000101010
11000100000000100001000000000000000000100010010111000111001001001000001001100000100000001100110001000
01000000001000100110000000100100110000000010000000000110000000001100110000010001010000011000000100011
10100100110011000000000100000100001000000111100100000111001000000000010001011011101100001110001001000
10000110000010110000001001001001001010000011000010010011010010000100011100000000010101000011000010000
00100000000101000000000000000010000000000000101000001000111010100001000000111001000100010000000100001
11100000100110110110000000011100100000000000100010010010110000101100000000100111000000000100000010011
10100001001001000001110101000101010010010000011000000100010100010000000000101001101001100101100100001
10001000101111100011110100101001001001010111000000000110100000000000011100100000001000110000000000010
00001000000000000000001110010000110001010000010010001000010100000100001000010000010000011010101001011
11000000000001110101001000000000100011010101011010001000010000010110011010000101110000010000001000000
10100001111101101000010010100000000010101100000111001001000001000101001011000101100010000000000000001
10110000000100001100000011100010010010010000000101000000000000000011100001101100101111110100000000110
01001100100000100010000000010010001000010000101110000100100100000000010111100100000110001011000001000
10110001100000000111101000010000001100000001100010010010110100111110000000010101001000000001101000010
10001010001010000001001000100100100100100110001011001100110001000000001000000001000010000000101000100
01100000100101000001011000000000101010000111100011100110100100100001010000001010100000000000100000000
00000101011000000000100101100101101100010000000010110000000000011000011100000111000111100000001000000
01000011000000100000110101000000010001100000000010011011000000000100100010000010111010010001001101100
10010000000001010101101100010101001000001010100000001100100111000010100010000000010000110000001000100
01001000001000010100000000110000001101000000000100100000010000100001101001011101001011010000100010001
01010000001000000000101010100000100011100000000100000100010001100000100000100100010000000000000101001
01000110100010110000110001000101000000001011100101101010001011110000001100000101000100010101101001100
01011000000111101100111000000000000100010000010000000011010110000000101010100101000010000001000011000
00010100011001000001010000011101000110000000110010111010000000001000010000000000011100100001001101100
00000000111101000000111011000110000100100010000011100010110100000000100001000100001000001010100010010
10111001000111001011011000001000001111010000010000000000000000001100100100000100000000100010100100100
00000010011000001011010001100001010001110001001110001000000011010011111000010100000111000000110101000
11000000110000100000000001011000000010110000001000000000000110000100001001000011100111010001010011010
11110101001001010000000000001000100000000000000000100100001100010000100000100000000001011011110101100
00001000001011010001010110000111001000110110101010010001101001001110000010101010001111000000110100000
00011000001001000010010001110110011000000001110011000000011000000000000011001110111010010000010111010
00000100000010100010011000101010100100000100101001000000010010010000001000010000000100111000100100000
00001101110000101011001001001000000001000000000101000111000000000110010000000001001000011000100000001
10011100000100101100110101101111100000100100110001010000100000110100000000010000001100000100010000110
01000001100010000011000010000101000100010010000000001000101000001010000001111100110100100000111000000
00101101000110000000000100001010000011010000000100001000001000000010000010011000010000011101010101000
00010100001010001010000100000001000001100000001001011110100000000001010001000000100110000010110010000
00011001000000010010001100000110100000001111101111000000001010010000111000000000010000100000100101000
10101000100010100010001011010100001010101010000001001100110100110111000000000010100000100101001010000
01010000000110010011001000011011000000001111000000100000010000100100010000000100101101100100111100001
11100001100100001000100000001100000010000001100011010000010100001000011100100010000100100101000010001
00100000110011001101100001101000011100000000001000000000101110000000011000001001110100000001110010010
01000011100001000000001001000001011101010011100001100001000010000110010000000000100010101000010110011
10110101100111000000110001110010001000100000000000000000100111001110100001000010000000101001100000100
01011110000110010010011000000001111000100100011000010000100100110000101000010010000100100001000001001
00010000000000000010100010000000001000000011011001000111000100000001100100100000011100010011000101000
01101001100000010000100110011010001100111100001001000001001100010000011001000100000001000101000011110
10010111100000001000001100110000000000000100011110010000110100001011100100000001100000011100100000110
10000010001011011101100010000000110011011001101001011001011000110000011000000100100000001000000000101
01001000000100001001010000111011110010001001000010000100001000100001000000000010000000000010000100000
00100000000100010000011000000010000100000101010100000001100010010000010000010000000001011001000100000
00001000011000101001100000111100011000100101110110100000000101010000000000011000001011010101001101000
10000100110011000000000000011000001010101101010000011010000010000110011011110001011000000100001000001
00001010001010110010100001010000111000101110110000111000001010100001001000111000001000001100001101000
10000001100001001110000100000110000000000011101000000100000000010000111010000000100000000100100000010
01000011101010000010010000110110010000001100101011101000000000000110001000000010000010100100101000101
