00001101000000001100100100111000000011011001101010011110001000110100001101010101000000010010000010000
00000000000000000110100001100001001101010010000010100110000100011000101001000111100000000000000111010
10000000101000000100000001100010101100000100100100100000010110001001100101101000100010110001001000000
00010011001011000000100010001000000000000111100001100001110000100100000000011100000010100110000011000
01001111101100001100010100010101100010001010010011001000000100000011010110000110011000100001011010000
10100110101100101010000101000000000000101000111010000101111010000000000101000111111000100000000010001
01110000100001000010001110101110001000001000000100011100000000000010000000000100000101000011111000000
10000000000000010111000000000010000000101011100000000101011001000100010000100110001011110001011010000
00001111001000000000010000100001001010001111000100001100000100010011000000010010100010101000000000011
10011001100110101001100010000101010100101000000000000010001101110100001111001110101010100110000100111
00000000100001101000011100100000010100100101100000001000010011010000000001011000000001011100101000000
10100011010011110101000110000100001101000010001101000100100100011010000101010010011100010000011101000
11000000111001000000100100010000001000001110111100010011110001000011000010010000100000000010111111100
00101100111110100000000001000001001110010000001000110000001000010000110011011100000001001000000000000
01010111000000010010000100110001000100000011000000000001011100010010000000000010011010000101111100011
00000000000010101101000001010000011001111111010010010000001000000000000010100010110001110001010100101
00000100100100010010000000110000001010010000111001000000101100000010110010010000100001100010001001000
01010010010100001000011000111100000110000000100001010101001010011011100101000101100000000100100000000
00000011000010001010010010000100100100000010101100011110100100010000101110110001000100001000000000000
00000100000111100000011110010000010100101100000100001000000000101100001001001010000010000010000000101
00000101010000001010111000111000011001000000101000000100000000000010000000000000001100010000010000000
01100001011000000110010000000100000010001000000010110000110110000000111000000100001100100111000000001
11001000100010101001001000110101011110010011110000000101101010000100000001101010010101101000010000100
10011011000000100010000010111101000000001000000000001000001001101010111000011000011101010000100000000
00001100001000100011000001000010110001001110000000010000001001000010001011001000011000011000000001111
00111110000101000001000010011000010011100110101000000001110010100011000110001100110000010101100010000
00010000010000001000000000000010011000100101100001011010010110101010000010011110010011010001001001000
01100011001000011100001100010010010000001010000100000001101000011101010000110110000000000100100000000
10011010011000011000100100010010001011011010100100101001011010000000110001000011000000010101001100000
11100000000000010110101011010001111001110110000000100000000000001100000001001001001010100000100000100
00111000110001001000101000000000000011000000000010001000111100000100000010110001001000010100101010110
11001000100001101000111000010100000000000101001000001100010100011000000100100100000000100000000101000
00000010010111000010001100001000100001100100000001100011000000111101000001000011101100100101110100001
10111000000100010001001101000000000000110001000000011000100100001000000000101110101000001000100010001
00010010001110010001000001000000101010000010100010000011010100110000100110000110011000101010100101101
01000001100000000101000001010000001110000000000100000001010001000000101000011000010000001000000010001
00110101000010101000001000001110000101000100110001000000001100100000101001100010010011010000110000101
00000100101000010101010010111000000101000010101000010001100000000110010000010110001101010000000001001
00000111110001000000010011110001000010001011010001000001000000010010000011010100000000010000000010110
10001000100001001101001010100001010000000000000010101000001100000011000001100110000001000001000000100
00000010100001000001111000000100000011101100100110110000001000100001000011000010011000010010111000101
00000010100010001000110010011000001010000010011010110000000000000000000110000011000000000000100001100
00010000000010100011010010011010000010111011110001110011111100110000000010000010010001101000100110000
10100000100000000000011101001011010011010100001001000000010011100001000100101000000110100001010100101
00000110111000000001000000000101000100100011010110000101001100000110000010100001101000000100000101100
00010110100010001000001010000000100100100001100010010010111000011001000001110001001010000101000100100
10111001001001100111110010011010000100010101010001000010110000010000011001001010000011000000111100000
11110010010100111101010000000001011100000001001010000001000000000000001000011010000011011101011000011
00000011001010000101100010000000100110011000010001000000010100011000000000011101100011001000001101010
00110000001000000100000000100101000000001000100010010000010011101110110000001100011000100010000010100
01000000110000111010000000000011100001000000101000111101000010110000000100000100101110011010000001000
00010000010110101100011010110001000000001000010001100000000001000100100101011011010001100100010010000
01100000101000000100000010000100000000011000000101100000110100000001000000101000001000100010110010000
00000000000001000001100000010110100010100000000011010001010000001100111100100000001000000001000100001
01100000101000001001010010101000000100001010101000001000001000100100000000010100001000010001000100010
10000001110000010111000001010000001010101001101101000000110101101010001001000110100011000000000010000
00000000001111000100000000000010000110010000100000100011000001110000010010010000001000110000010010101
10000100000000101100010000000101000001100111001101100011011000000001010000010100000000010010010000110
00110000001110101101001000101011101000100100010000000000001110001000000000001101111011111001010000010
00101010000000000000010000110010110100010000011000000100000001010000011100000110001101000010100100111
00010010001011001100001010110000010100000101110000100000011001000000010101011001010110000001100000100
11011111101100101110100101010111000101000000000110001110100001110010001000101011101001110010010000000
00101100001000000000011010011001000001001011100000000110001001011100100001000011111001001000110000000
00010000000010100001100000100000000000010101010000101000000010000010011000000101000000100000001000011
11011010000010101000010010001100100000011110011100000010100000010000000010010000000110000010010110000
00000000010001100100001011101100110100011000110011000010000000101000100000110011100110000101011001010
00100000000000000000000011101100011110111010110100011101001001110011000111000000010001001000000000010
11010100101000100000010110001001000100010101010000000000000000101010101000000000100000110001110000010
00110000110000010001000000000001001100000000010010001010100001000000000001010001110001000100000010000
00000000100001001000100010000000111110000010000010111011001000000000000000010000001101000000000000011
10101010000000010111010000000001010000101000100001100001001001010110000010001010000100000001000100000
00100000100010000001001111000010010000000001000001010001001010001100100110010011010110001000100101100
10000110000001001001000000000110010000101100100010001010100000000010100001110011100000110010100010001
00000100000100010000000100101101011000000010001000010001100100011000101000010110101010000000100011011
01000100101100000000000100010000010110000010100000000011111001101001100101000001100110000011000001000
11000000000001001000101010100001001010000001010000000100000000001000000001001000000010000010111000011
00101100001100001101000000001001000100000001011011000100010110001100000000100001100100000100101111001
00100010000001100100000000101010000011000000010001000001111101001000010010100110000110010000011100000
01101010010010011001100110101000001100000011110010011011000000000000101010001000011000000101001101001
10010001000000000000100100011001000011000000001001000000001010001001000001010000000100000110000011110
00011010000000000101100100001000000011000001100010000101000000101111000000011001100001100010001001100
00100100001010000100000010000010110110010010010000110000001110010010100001100001111001000000001000010
01001000110100001101101010000010101101001001000000000000110000110011100111100011101100001011001000010
00100000100000001000001000101000001000000101010100001011000001100011110010000011000001001011010000111
00100010000000000101001010100001110000100101011000100010001000010100101000101100010110000001000000010
10100001000001001110000000000001111110110001000100000100101110101000100010000101100100100111000000100
00010101001000100001010010000001110110011101000000010100001100010001010010100111001000001110000100110
10000001101100101000001000000001101101100110100001010010010000001001001000000000010000000000100010110
11000000101000000100000010010000000100000111001001000010000000000100100111010000010000101001001001011
00001001000001100100101000000001001100010000111100110001110001000001000011101000001001100001001000010
10010010000001001100000110110110010100000100011000001100110110000110100100001110010000011010001001011
00000000000001000000001000000100101010000101001100010011110000000110101000111000010000001100000000000
00000100101100010000000110011000100100000000100001111000001000101000011001100100000000100000011110000
00000110000011000000011000110001101000101000010011000000000101100000100100000000100000000100010111100
11001001100101000001010001000000100101101100100000110101001100000010110100010000100000000000001100001
00000000100001000000100010010100100100000110110101000001010000000100101011000001001100100110000010000
01001001000000000000111101000000010000010001001000100010100011110000001000010101000100011000001100001
01001100000110000100000001100010001000100011000100001000011000111000000100001000000100100000000001001
01110000000101100001010001110101100111010001000100010100010100000100110000000000100011000100101101000
01000100000000000110100011000110101001001000110010100101010000100001000010000000000110010100010001001
00110010100000000101110110001000100000111100110001000000001010001111000100110000001100000101010001000
