10000010001000100010100100000100001000010100000010101001000010100001000001101000000011001110100000010
00100000100000100000110000000010000001000010000001001100001010001000000010010000100000000001000000000
01000100110010000000000100100001110001101000001001000010011000000000010000001000000111001100000000001
00100001001000110000001100100000000001111000000000100000000000000000101000010010001101010100001000101
00000000000100001000101000010001000011010001000100001000001110100000110100010001000000000110101000000
00010100000000000001000010110000010000101011011011001000110011000001000000010000000000000110000000000
00000000000000110000101100000000010000000000010011010001111100101000010011000000000000000010110010100
01100001010101000000110001000100000010001010101001101001010100011000011011001001100000001001010010100
10000000100000001010001000000101100000100011100010000011000001011000000010000100000000000101100111100
10110010010010001000111000100010010100000000001001101010101000000001011010100001001010111100000100101
00011000101010100001011000100000010001010011100101000010110010000001001011000100111000000000100000000
01100000000010100001010000011000100000000100110100000011110010001000010000000100000000100010001000100
10111010010100000000001000001000110001011100100100000110000100110000100010000010010001000010011100010
00010001001011110110100000100100010000111100010000110001011000100000100100101001000000010111100000001
00111011001001000010001000011010001110001000011001001000011101101111000011100001001000000011001100000
00010010000000010101000001000000000010010010100010000011100010000001000111000100001000011000000000010
00000000110110000010000000011111010001001010000010000000101011001001100100010010001000000010101100000
01101000010000000100101010011110101000101101010101100100000000101000000010100101000010000101101000000
00000100000000101100001000010011100101110001100000111001010000000110100011010001100000110001011010100
11001010101101000000101100100000001110000111001010000100001000001001111101000010000000000001010001010
01000001000001000001001000000101100000000110000101000000000100110000001010000011000010000000000100010
00110011000001000000010100100000011000000001000000111000001000010110010010000000001100100111000010010
10000010110001001010000010100001011000110111100000011000001010100110000000000110111000011000111111000
01100100000000111101100101010100100000001100000010100011000000000001010000000000001100000000100111001
10000001000101000000011000010010101000010100101010011000111100000100010000000000000000110000010110000
00100000000010010001000011000000010001000000010011110111000011110100000000100000011100000010010011111
10000100100001000000010001011110001001010101001000000001000100100111100110000011001100010011101000010
00010100001000000000001100100100001100000000100000000101000010000100001000000001000100000001000010001
10010000001100000100010100010011000111010000000011011000000001010010000001000101000001000000100010001
00001011001001111010000000011101011000000100111110000010100110110000001010100000100011000100000010000
11000000110111000000010110000000000000000100001100100100100000100010010000110010001001000001000001000
11100010000010000010000010010000000001011010001110100000001101110010111101100000100000010010010000011
10110000100000100001010000001110111001000010000000100101000000000000100100000100010110011000011100100
00011000000110001000001100010110110000000000101111011011011001110101000001001100100001000001100100011
00000100000010111011000000000010001001000000010010010000000000010000001101001000110010100100010011100
10100010010110000100000001011001000000000000100001000100000100000100000000010111000000000010010000001
01001100111000001000001000101010001010110100000000000000000000000100101000000100100000000110000000010
01010010100001010110110000000100100000000000011000000011111010000000000000000000110011110000000000001
01110011010100000000001000101001000000000000010000001111001000000000000000001000000101010100110100000
10100100000001001000010000001000101001100100101000100010001111101010000000100000100100000010000000000
00000101010010000001000010110001001110000000011000000100011010100100101101000110000101000100000001001
01000000100000000001100000110111100010000010000000010011001011110001100111000000000000000001010010001
01110000001000111100000100000000101101010000001010000111100011000001010010010100000000000001000100011
00011100011000001100010010010100110111001010011100101001110100100010000000010000000000101101011000110
01010001010100000010000000000011001100000111001000100011101000110100100010101000000000100000001010000
10000011000000000000111110001000100011100000010001001100001000000100010100110100000000011011100100000
01101010000000100000010100000001011000001100001000001011110000100011001011000000100000100000000000100
01001000000000010111000100111000010000011110100110010000000000111010100001000110011100001000010010100
10101001100011000000100000000100100000011011000010011111011000000010101011010001111010001000010000010
01001010101011000000000110010101000000010000000000001110010110100011010011010000000000010000010110000
11000100000011000101101101100010000011000001000000010001001001110000001000000001001010100010100001011
00001001001011000100100001001011000110101100000111100000110100110001000000110101010010101000010001100
10000001010000000001101010000010000111010000100001010010000001100001100000110111110000000110000100001
01010011000010010000101000000010010001000100001010000000100101100011010001000010010000000000000001101
00000100010100110110110100000110010000000011000101010011101100000010011010001100000000110001100000000
00110010100100111000000101010011100010001011101000010011000000010101001000010100000011110001100100100
00000010000101011010100000001011110001010100000010000000001001001101011100000100000100111101001100000
10001111000000010101100000000110000100100110000001001001000100000000001000000000111101010010000000100
00100000100100000100110110000000001100001001100100000011101000011001001100100000001111111000110001100
01010000000000110000111000000000101100010001000000011011010000000010010010010100100011001110100010100
11001000100101000001000000100100100001000000000000010010001011100000001000100000000001110001000010001
01000001010000000010000111010110100000101001000000010110110111010000100100000001000010000010000001100
00101100011011000000100110000000000000100010110000000101001010000111000011101000000000101001101011110
00000000000000000101100100010000100000000000010110000000000000101000100000000100000001010010000100000
00000010110000001000001010000010001001100101001001000011101001001000000000001010010101000100010000000
00000000000010110100101000000010110000000000001010000000110000101010100100000000100001000101010001110
00110100000010100011001111001011000001011000001100001100011010010000001001001000000000101000100111000
00001000000010100000000001100001011001001000011110000001001001110000010100111010011001010000100100010
00000010110000000000000000101100001100100000110000100110100000001000010000001010000000000000100001011
11000000000010010000000101000000000000000010011011010000000001000000000000000011110000000110000000000
00010000100010101000100000101100110010000110000000100010101111001010000000000010000000001000000100011
10000000000100011110000000001111000000010000010111101100000001011101110100000000001000000101101010010
01000001000000000000011110110000000100000001000010001000000000000000010001000110000011000000101100100
01010110000100011100011000001100010000010001010000000010110010010110010000000000100000010100000001011
01000111000001000010100000010000000100100000000101001000000111000001000011010000000001010000101001001
00000001010001000100000001011000101001100001001100010010010000000000010000110000000001000100000100000
10001101100101010010001010011110010000011100011110110010000000001000000000110000000101001100101100001
01100001000010000110001101001000000110001101011001000011011010000000000011011100100110100100000111000
10000100000000011101000000000010000101001010100000100011100010000000011100100100000001001110101001011
00001000010100100000010010000110110100101100001100000010001000111000001000010100110000110100000000010
00100000011000011000101110001000010001011101000101000011010001101011000001000101000001011100101110010
01000101111010100000000001001001010111110000100110000110110100100100010000101100000001000001100110000
01100100010000000111110001100001001001000100000000010001110000010100100101000011000000110100000001010
10010000100000010000000000000000110010000010000101001010001001010010101100000010010100001010010100001
01000000000100000001000100110000000100010010000000010101010101001010000101010000000101010000010010100
10010110010000110010010000001000010100000000000000110001000000000000100110000100010000110100000001101
00010000001001000100011001001001000101011100000011011000100010110010011001000100000000001100010000000
10010000000100100000000000001010110000110000111100000100000000000000000000000101101101000100010001010
10000101001101011110100010000010100000100001000010101101101100010101010101010110110010010000001100000
10100100000010010010011100101000011010010010000001101000100001001101100100100010000000011010000001001
00100100110100100010000010000001010110110101000000110000000001101000011101000000111001011100000010101
10000110000110101000000000010010010010111101010000010100000001010000000000101110001000000100001010100
01110000001111010010011100010000000000101010100010001000100010000001010100100000010001101100000010010
01010000100000110000001110000000001000000100001100100011000000101000110001000100001110000001011001101
01001000100100011010000001001000010010000001000110000001001011010000000001010010000000000000111000000
00000001111100010011100000000101000010010000001000100100110001100001011001101001000110100010000000001
00101000000011100010000000001100000000011000000010000000110000000000000111011110000001111001100010000
00000000011100000000000000001000001001000101100000101010100111000011000000000001010011000000010011000
00100000000001000001000110101000000001000000000001010010000000000000110101001000000010000010100000000
10001110000100010100110010000100110000011001000000010110000110110000000001000101000100000100010100000
10000010010111000000100000000000001000000100010000011011101011100101101010100001010001000101100000001
