00001100000100001011000001000100100111000101101110100101110000000100010010100000011100100001011010010
10001000000100000100000000010001010001111001001011000110000000010001100000000011011000000101001110011
00111110001100011100000000010000100001000111000000100000001010100011010100001100000011000100111000010
00010001000101000100000010001110001000011100101010011000000001110000101011010100101100100010000010001
01010000010000000111011001011000010000001100011100001000000101011010010001101000100000000010000000001
00000110010100011100000011010010010010101001001000010000000100000000010010000000001110001000001000000
00010100000010110001100010010100100000000100101110001000110101000001000000110011000001100000001000011
01000001100101000110000101000110111001010000000011010000101000010100100000000001100100000000000010000
01100000110010100001110000000011001010000000010010000010001001000100011011001110000000000001010110010
00010001001100000111100010001001000101001000000001001000100001001110000000000000100101010110000000000
00110111100010010000000100101000101100000010001100000000000100001000010100010101000010000010000101100
00010000010101110001100100000000000001001010000001000100110000101101111100000000011111000000001000001
01000111000011011100010101010101000011010000000000100011000000001100000100011010100100010011001100000
00000000000000010010100101001010000010000011000011101100100000010001000000000001111101000101110011011
00101000000001000101001010010000011101000001000000100101000111000000110110110000110001010010010000101
00101000000101100011010010000000000000101001000000010110000110000100000000001001110010000000001100010
00010000010000000001110001001010100100011000000010101001000100000000110110010000111000100010000000000
11010000011000000000000000010010011001011000100000111111100000010000000000100011000000100000101000000
00010001010101100000010000011001001010011101000010101010000001000100000011011101000001100011010011100
10100011010000000100001000000110000000100010000100000000001000001000101000110100000100000000001100100
00000001000000010010000010110000001010100000110100010100011011010010111100000000011001010001011000000
00000001000000001000010100000000011000111000011000001011110100000011101101000000110000000100110001001
10110001101010000000000010010100000000100011000000000000010010111100001000100000000111000000001100000
10010000011000001000010001000110101010000110000001110000010100000010100000100000000000100000001000101
10011000100000101100100000000101000010010100011010010001001000010100000101100010000000010000001010000
10000000100000100111011000110001001000110111000100000111000000000011100000000011100000000000000001000
00001011001100000011000010010110001000101100000101111000100110000010100010000101010000010011001100001
00010000000001001011010100101100000000000011010100101110110010110100110000000111010011000100000110100
10000000110100110100001000100001110000001000100000010110101000000010000101101001001000000000000000000
01001001001100000100000101010010001110111000110011110001100000001000000000010001000000000100100001010
00000001001001100010000001000111000101010100010100001110000010000101100000001100100100001000000001101
00100001110010001000111000110010000111100000000110000000000000010100101100000001100100000000010011000
00010001001010000101100000000011000100000000110001100000000100011111111011000101110000101100001000000
00000100101001001100000101000010001010011001011001011010011100000000000111000110100000010001001001000
00101100000001000000000001001000100000011001010000000111010010100000000001000000001000001010010000011
00000001110000110011000100000001010100000110101001100010110100000101001011101010001000011000010000000
10001001100101001000000001010000110100010000000000111000000001000111000010101011001100100001010100100
00010010010000000001000010100111000100010000100010011011100001100010100100011010010001010000000001100
00011001010010110010100001100000100000010010101000111000001100111100100100110100001000001010010110000
01110001000010001001100101000000010000000010010001110001001101010000011000111000001000000000001011010
00011000000000000000000000100101000000011100000011000000000010100000110010100001011100110000000100000
10101000100010000110010100010100000100001001010000101100110001000010001010001010000000001000001010110
00000100011010000001100111001000001010001010100000010000000000110110010001000001000010100011100001000
11101001001101100100000001001110100000001101001000001000010001000000001010010100111100010001000000001
01011010010000000100000000101000000001100000101010011000110100101110000000000000100101000110110101000
11000011111011000011001000110100110001001001000000010000001100010100100000101010000010000011110000001
11001011010000010000000100000000000000111010001100100000010100000000100100100000101000000011000100011
00000000011000000011000101000000000000100000000000110000000000011100000000100011010100001000000011000
10000100100101100000100001100100001101011000000111111000101100010010000000101000101110111100000000000
00111000010100001101000000000000110011100110110001001101100000100000000000110000011111101000001000010
01010010000010010011000010000100000000000000010100000001100011011000001011110000010000000011001010100
01000100100011010000000110010001010010100000000001010000001000010100000100000111010000101100000001000
00000100000011000100000000000000110001011000100100001001010100001001110010001001110011010100100010000
01010010000100000100100000101000100001001001011101000000010010010011000000000001000111001100100000101
11010001100001001011000000001111101010000100100000001000000000111010100000010000000001000000100010001
11011100100000000001000000010100100110100000100100000100011010101010011110101100011110000110110001000
00101000001100100000000100000000000010000000010010000000011000001000000000110000000000010010000000110
01000100010110000000001100010000100010000010010011110010001000001000000010111000101000110110000110101
11001100011110000001000100010000011001011010000000100010100000000000100000000100110000001010001110000
10101000100110000101100110010111001001110110000000000100000000011001100100001101110001101001000010010
00010110000100101000110000001000000100000000011000001010010001100000001000000011001000000000101001000
00101001000110010000100000100001000000001000000010000111100001100010000100011000101000010100110001001
00010010100010011001010010001001010110000110000011000100101100001010000110100000100000110000100100010
00000001001101010001100101100010100100100001010000010011000000110000110001000111110010000100011000000
10000010001011100000011111101011101000100001110100110000100100000101011000010100010110000000010011011
01001001000010101110010101101000001110000110011010111001100100000000011010000010100000100000100000000
00000000001000000101110110110101000000000010001000000000000010001011001110000000010000000000000000100
11001010010001000100000000000110000100100001000001000100111000001000000111010110010000000000001001010
00100000101110000010000000001000100010000110010011110101000000101100001010000000000001000000100100111
01010111000010001010101000000010000100010010111010000000000000010010101000010100010110001110101000001
00001000000000001110001100000001110000010100010010100000000001000010100011000001000001101100011000011
00000000100110110000001000010100010011010001110011000011100100011000001101010000011101100101000011100
00000011010000110001001000100101000000110100010011100000000010000010010100001001100011101100110010100
00000000001010010000001000001000110010100001000101000000000011000110001100000000111010001110100000000
11110001001001000010000000001100101000011010000000101011110000110010000000100101100000100000000010000
00011000000000000010000000100000100000101000001001000010011001010000101101000010001011000010100000100
11010000101010010100000100010000010000000100000000000000000000000101001100000000011100000111000000001
01100100010101110000000101001100010100110001000000100100000010101001100000110000000000010100000101000
00101010000010101110001001110000000000000000100101100010010101010000100001100011110110101100110000000
01100001101000001010101000011111100010011100000100100010101000010110001011001001000111100101101001010
00000011101100100001010001100100001010000000001000100100010100101000010001010000000101010001000000110
10101100110000000000000000110000100000000001100010001000000100101111010010010100101111000110110101011
00101010001010011010001001010010010010100000010001010000010000110000000000000001001000100011000100000
01001010010000001100011101101011111010011001010000010010100100100010010101011010000100011000101001110
00110100100001001000101100000000001000000010101100000101010110000100001010100010100100011000000100001
10001010001010100100010000000111110000000010000010000010010000000000000010000100100000100000011000010
10000000000110001010000000000010000101000001011000001000001010001010000011100010000010011000001011001
00000100000000001010000010010000001000000001010000100010000000001000000001100011010010100000000010100
00000110010000011100000001001000001101110111001001000100100101010000100000000100000100101000000001100
00010000100100110001101001011011101010010000000101101101000100000111001010100001001101110000100000000
01000001100101101001000011000010010001001000000010000100010110010010100010000000101000110010111000001
10000000001011001001100000000000100000000000000100100101011010010010011000011010001010000000000100000
10000101000010011100000000101010010000010000010100010100000000001101100000001111101100101000001000100
00010001110000000000010001010100011100010000011010000011000100100000011000000001010111010100100001010
10011011011000100000100101100010010000001001001100000100101001000010001100100000001000111100010011000
01010000101010001000001111000000001100111000000000100000110000110000100100000001011000010010100001000
01100000001101011001000110110100001101000011001000001011100110000100010001001010010000001101001010000
00000000100001001001010001100010000100001000000011100100011010111010011100000110010011101101000010001
10100100011010001110011000100011000010000010000010001000000000111000000011010100010010010001000001100
01000000011000010001110000010100011010100010000000000100000000010100100111110000001001001000001010001
01000010000010001001100000000110000100000010000001010001110001001000001000000100001100101000001010000
