00011110101001000000000010100011110100000011001110010111000001000010000000001001001010000010000001100
00001010011000000010100010110001110111000100011000101100000000011010000000010001010000001001101001000
00110000001000000001100101010010100011100001001010100101100001000100001000111100000110101010001001110
01000000110000000010101000100001000100000001000100100100010000000101000001011001010001100000101000000
10000100100101000001000001011011000011010100000000010000100101000110001110011010100000010010101000110
10010000000000000001100000000100001000000000101011100001001000110001100001011110110010000010100011101
10000000010001001001000100001100100000000010001001001000001000100011100000000000011100010000100110010
00000000010110000000010010000000000000001001110011000001000000000100010000100001110010011110100100000
00101001100101000101010010000011001111100100001101101100110111010000100110010000100000000010001110111
00110110000011100000110000110010000010011100000111011001000100011000000010001000011000100000000000000
01000000000101100010100001100001011000010000111000000100000000010011000000000000000001000010100010001
01000000010010001110101000100010010000100000000000010110000000001010111000001000010000000010010000110
01110000100001000001100101010101100001111010001001010010000000110000000111000010000000000010100000000
00000101000000100000110000100000110000001010000101110010000011001110000010010001010000100001000100000
01111100001110101101000010011000010000001110000000001011001100000100001110000010001000100100110100000
10000111000010001000000001101101101100010110000000001111010100001010000000100101011110100100000001000
00100000001000000000101101000111000000100000100000000101010001000010010011011100100001001110010111011
01001100010001000000000001000000010100010100111110100111111100110010000100000000100000000010010010010
00110001111100010000100000100000001000000000000010001110000100000101000000000011000000001101100111000
00010100100000000001101001100101010101000110110000001111000100001001010000011000010100100011010100110
00000010100010001000001110110010001000111100110011100000010100000000001000100000011110000000000000000
11000001001010010010111000000010000101010100011001010000001101000001000000110101001100101000001110010
00100011110000000000110010100101000010000000000010010011001101000101000100000000000010010011101111000
00010101001110001000100100000001000001001010000001001001000010100101001101001010100000110011000110001
10000000001000100001000010000111000101111011110000010001010010011100000001000001100011010000100001110
10000001001001101000101001000100100001000110000001010101100001000000000000000010101010010100010000000
00100011000100001000001000101101111100100000010101000000011010100000000000101000000010001000010000100
01110101100000010001000000000011001100000110100011000010101000100010000000110100001100000101001110100
00010010100001010110010010001000010000000000100001101000001100110000000010100010010000000001010010101
00000100110100011000100111000010010001000000000000000001010001001101000100000100000010010010000000001
00000100001000100011001110000000000000100010000100000000010101001000110000010101011111100000011000000
01000001001000001101010011001110100010000000000010010110000010010001100000000001100010000101000101000
00110001000000111001000110001001000100100000000000010000101001000001001000110000001010000110000110101
00100011110100110000100100010000001000010001101000101000000000100000000100000000000010111000100000101
00001011000000001100110010010010000010000010010100101000010001001000000000000101000001000100000001100
00000110010100011001101101111100110001010110100001001000100111011001000100000100100110000000000000100
01000000000001001010001011001010000111000010001001100110010100010001101010000100010001000000001000100
00010100010111000010000010010001010010100000000000001001100110101010001100011010000000000101011100100
01010100110100000001000001111010001011000000011000100000001000000100011000110001010000000001000001010
00100001000010001001110010000000001000010010000011000001000100000010111011100000100110000100010100001
00000011100000000001000001000000110000110010000000101100000100000000000001011000010000111100100000010
00000000001011101000000110000101000000000000100000100000101111010011000000000000010000010010101100000
10100101010000110001011010000000001000011011010100100001000000010101110001000000100000101111000100110
11100011001100100000001010001000000011010001000000011001100111000000000010001100110101000001010000000
00000010110111010000001000100001010110000110001011001101010100011000110000011010001011011010101100011
00000001001000101110001000010001000001010000000010000101000000011000010100001010101100100100110000000
00100101100010111011000100000110000100110110110001110000100000101000001011010010100010001001100010001
10000100010111000000010001001100011000110001011000000000010000000010111001101000000101000001000010010
00100010000001000000100000110000010000110101000100010000000011011010000101000100000001001100101110000
01000001010001000011100101100001000110010100011000000010100000000100000000000000001010000001000100000
01001100011100100010101101010010000000010001100000000010110011010000001101001000000000110000000111000
00001010010010111110000010001010101000000100000000110100001000000010000101000001010000000000010000000
00001110110100000101101000001000010000100001000000000001001000000000110001000000000010000000000100100
00000000001101000000001000010000010001100000101100001001000000011011000110010000100010100010101010010
10000000100000000100000000010101000000001010101101001111010010100100110000000000011001000010110000100
00001100011110001100000001001110011001000001000011001110110100011001010000100001101101001010000000000
00001100110100000010100100010000100001010000010100000010000010100111000010010011100101010100000101100
00001101001000000001000001010011001110000000010000100000000011000011000101000000011011000001000100100
01001000001100100101001001001001000010000000000101010010010000001011010110100010000010001010110010001
00110000010000011010001110000011010001001000111010111010000001000000001100011011001000001100010100000
00001010010011100001001100000010000000000100010010000100111000101000101100000001100000001100000110010
00000000000010000000010001000101001001110111110000000101000101100000010100001100000000010001110100100
00010010100001000010001110110000101000010100001110000001100000000000000001000101100010010100001000101
01000100000101010000000000100000100100010000010000001001000000100010100010001000000000001000000101100
00010000010100010001110011001100000100000100000100000000000001000011000000000101101000010000010110001
11000001010101000010010000111000000010011000100001001010000011101011001010010110100110001001000110000
10000100000000001000000001110101110001001100000010000101101001000011100011010001000100000000000000100
00111000011011010110010100100101000001000000100001010010010000000010000110001000010001101001001100000
10000000011110100111000001000111000000001000000000101001100010101000000100010001010110101000110100001
00100000110010001101000000111101000100000110001010000010100000010011001001100001100000001001000100011
01101010001000000011001010010100000000100000010000101101000000010000000010100100100100000010101001001
01000100000000010011000010001100100010000001000100011010110100110010101001000000100100010010010100000
01001011001001001010000000011000100010001010000101000100001100001001101000011000100010010000000000000
00101001011000000000000100000010110100010001010000010000000000010001100110011000001001100000101001000
01100010110001000101100000010101111000000001010110000110001001000110100000011000000100100000000000001
10100100000000000100010011001000011000000100000000011100100000010111001000110011000001000000010010010
10001101000101001001000000000011000000000101000000011010101101000111010000001011000001001100100000111
00000000101000110100000000110000000010010001100100010000001000000000010100110100110101100000110101001
00110101001000010100100100000000101001000001110100000010011110000101011101110001000010101001010000110
01001100000001100010100001001000010000001000000001010001000100001100010010001000010001001010000010100
10011100010000100100010100000000100100000010010010001000110000010001000000110001001011000000100110100
10100000111000000000000101100001000011110101000110001100100011101000110000001010111000100000010000001
10100000011111000000000000000001101001110100100010000011010011000000101010010010001100111000001110000
00010100001001000010101101101000010000010010000001001010101101010001101101000101000000000001000100000
11001110001000101101011111110010000100000000000000000000000000001011110101100011000010000001001000010
00011000000011100101100010000000100100110100110101001001010001001000010000100000100000010000001000101
00000100010000000000001000000100010011000100101000000001000000100011001010010010000000001100010001100
01000100011110000100010000000000001000001011010000010010011011000111011001000101101010000000001001001
10011110100111100000001100000010010000101000000000000000100000001010000000000010000101000000000100001
01010000100010001100001000101011000110000010000100100000101010000001000000010000010100111010010100010
01010000001000101010001110011000010101110000010100000000010100001000000010110000000010101001000000000
00011000001000101101000101000100010000011000010100100101100010110000100001101000100100001110100011000
00010011100100101001101101001000110010010010010000010000001001000000000000011000100010000011000100100
00010100001011001000111000000001110000100000000000100010000000000001100110000010101010010110110100111
10010001100111000000001000010010101110101000111011000000000100010101010111100100100100101100100010000
01001101100010000001000001010000110100000000000010100100010100000100000001001001001000010000111000110
00010011011001000000010111010110100000100010110001110111010100100001010011000011110000010010001101000
00010000000001001000000000000010001000000000000101001010001100100000010001100111010000111100101010100
00000001000000000010000110000011001010010010000010001010010110110011010101000000110100101000000100000
00110011001000000001000000110000001011001100010100100010010110001111000110000001110101000101011000000
10000100100100010111000110110100011100111100011100000100000000000000110001000000000011001100010001000
