10000100010101010010000101001100000100010000000000010001110100001110001000000010101110100011001100010
00000000000100011001110100110100010010100010001000000000100100001111001000001100000000111100000000000
00110011000000000110000011011111000010110011000010000001001011000010000001010110001000001111010000110
10100000110000111000101110000000000000010000000010010000100100010100110000000101000010100000001000000
01000000001010101000100000000000010001001101110110001010000000010011110000100000100000000110011001011
00100001101000001100000000110010101000100100000111010001001100000000001010000110010000100001000100010
00000100110010100000000001100000010100000100001101101001000101001100000000000100000000001100000101110
10100010000001100100000011000100010010000000011010000000001000110000000001000100010011000111000000000
11001000111000110101000010111000000100100101001010010010010000110000111000010100001000110001110001010
00111110100110010011000100001000100000000000000100001100001110000000010100110000111000000011101001010
00100000011010000110010101000000010000000001000000000110010001100010001100001000000101000101101010100
00000110101000010110110011000100011101100001001000000000011001101000000000010000001001001100001100110
10000101000011110011001011101001100110010100000100010101011000000000010100100001000000111010000001001
10000010000110000000011000000001001000000100000001010000000101000100010001010000111000000000100000000
00011010100000110001000001001100000001000100010000000100000000010100101000010000000010000000000001100
01000001110100000100000000001110110110000011101001000001001001111000000001000100000000000000000010100
11000000000000000001010100001000000010001101000110010001100010000110110100000101000110000100001100101
01000011001110100000000000011101010101000000010000010000011001100000000010000101000101000110110110101
00000000000011101100001011111111110000011000011010100000000100001000100010100000100110000010000100101
01010100100101100001000010001001000000101000000001100001011010001000100011010000000000001000000001100
01010110010110001001000010000101000001000000000001000000100010100011010000011100101000111100011100110
01010000100001000001011001010000000000001100100000101100100011111100001000000000100000000001000011100
00110000000010101010000010100000100100111000000000000100100001010010010000000101000000100001010000001
01110010100001001000010110110110000011100001011010010000001101100000100000001001000000000100100000110
00010001110000001000011110001001100100000001010001100100000001000000100000000000100000100010001101000
10000100001110010000010000110110000001000000000100000001000100000001010000000100001001010001100001000
00001001101000000101000010010000011000000010010010001001100001001000000000101000100000011100100101000
01000001100011000000000001100000011110100100000000000100011001000011000101010100000101000100000001000
00000010011001000110101001000001100100011001100001010110000000111000011000010100001001101011000010000
10100000001101000001010000000001111000001100010000000100001100011001011101100010000101000011010010010
00010000010001101000100000001010000011010100101000010000001000000010101110001010010101110101100000011
01110010001000000000000101001010100001100000101010000000000000000000100000000101000100000000000010010
01011110000100000010001010001010000110100001001000001101000000001000100001010000100000011000100110010
01000011110000010000001010000100000110110000011001001010010010000000100000010010000000000100001110101
10010011010100001000000100000000000000001000110000100100100000011100001001000011010000000000100000001
00110100000000011010001001000100101110110101001001010000010000101000001100110000010000110000100110000
00111100001000100010000100010000100001111001001000101101010001000010000001001000001011010100001000011
11000000000011000011000000010100101000000000101010100011011000101001000000010010001000101000000101000
00001000000000000001010000001100000100101000000000000000010100000010001000000111010000010000000000110
10000011000000100000000110110010111000000000100000000000100001000010100010010000001001010111010110000
00000100100111010010011000000011110000100000000000000000000101001100100000000101001001010010001000111
00000000111000111001111000000000011100011001000000000000100000100000100011001001100100001101000000101
01011010000110000010100000100010100001000010010000100000001010100001100000001010000101011001000010010
01000100100000011011000000010000010010000000100111100010000001010101000010101100001100000010110000000
00010100110000100001001001010100000110000001001001110101100110100000000011010001001010010000001000010
00000001100000001000101010000010001011011100000001000000000100100001000000001001001001000010101010000
01100010110000000010110010000101100001000001000000011101000010001011000100010011010101000110000001000
10001000001111101100100001000000010010110010010001010000010010010111011001001010000000011000110100010
00010000001011100000010000011010011000101000100000000010000010001000000000000101110101001010001101000
00011001001000000010100100110001001100000001110101010100000001010000100110111000110001011000001000000
00000100110001100000000100010100000001110101101000000000000001011000001010100110010100001001100000100
00100000000010001000011000000100000000001110000011111011100111010100110110001101000011000101101001100
01100100000000000010011100100100010100100110001001100111010010000010000000101100100100100011001011000
00011000101001000001100111000110111110100110000011000010000000100010000001010001010001100010010010000
00001111000010110000010010001001101000001100000000000000001010000000010100000000000101011101011000101
10011000001110000010110001011001000000001101010000001110100100100010010000000001000000010000000001010
01000110000000100010010110000100100000001010000010011001010100001000011000000001010100101100001000000
00000110110010000100000101000010010111111010100000010001000100100100100000000010000100000000101000100
01100000001110000110110111111000010101000000000000000010001011000010110010110010100000000001101010100
00000100010100000000110000000001001000100011011000000000110000100000001000011000001100101111011110000
10011100001100100011010001000000101000111000001100010000011011000001010010100000010010011110010100101
01100010001100001010001001110001101010100001000001100000100001000000000100010001001011000111000101001
00000010000100010001001011011010000000100101000001100110101010110000000001000000001011000000000011011
00011101100000001100010110000001100100000000000110101000000001100010000000000100001000010011100010101
11001100100000010000001100000100000000111101000110001110100000100010101100010000001000000011100010001
01010101100111000000010100000000000001000100000000101001110000001011010001101011100000010000001010000
11000000010010000100010011011000000000000001000011101000010000000100010110010100010010100100000011111
00000000100000000011010100100000000000001101000101000010011110010101100000100001010000001010010000001
11001000111000111100101000100001100010000001101010100010100111011001100001010101010000010000101000100
01000100001001000011000010000000110010100101000000011010101000010001100100000010000010110110101100110
00100100000000101100100011110011100000101000000001000100100001100011100011001101100000010010000101100
00000000000100010000000110010101010100010100110000010101010100100011010001010001011000010010101110110
10001000110000001100000000000000011101000001101000101010000010010000100000001110000000000000001010100
01010000000000110000000100100010000010100001000001001010010000101100010100101000000001100001100000000
10000110100010000101100010000000010110001000000000000100101000000001010001000001000000000101100110111
01000100101000010100100011101000001000110100100000100010110001000010001010000000001000101110000100011
01010110000110010000001000010010011100010000011000001010000011000010111011100100000100100011110001000
00010100100001100000000010000000010000001100100000000010000110001110000000101010000000000010101000010
01010101011111101101011000010101000000000000000010100000010110100000100110001000000110000001000000000
01000100100000011110001100000010110010100000101000000000001101000010101000000100010110000100000111101
11100100110000000001000101000100100000011100110010000100000011100001001100100001010111001001101000000
11000000100100101110000010000001010110000110000111110000000101101001001011111010000010000000000001000
00110010000001110100010010001010001101000010100010100000000010000000000000101001001001000001011000011
00010000000100011100011000001000001110000001000001000001000000000000000010010100101010000000000001010
00101010110100000110000000001000111000100001011000000001100100000010000000010001100000100000011000110
00111000000000100000010000010000000000010010000010001110001101000001000000011001000101001011110000000
00110001001010100100100101000001000001110000100000000110000010011000010001001001000000000100000111100
00000011010000001001000111000001000000010001000010000000001000000000011100010010001000000100100000100
00110011011100010010100000100100000100000001100000001100001001011000000110000000000000101000000010001
11100001100000101101010000100111010100000010011000100011100011000000110001100000100000000010000000000
01111000000011100000000101001000000000010101111000001100111010000110011001100100000000001010001000100
01000001000100110000000000100010000010100110010011001011001001000010010010011010001000100011100000001
01010001000010100100000000100001000001000100000010101001000100001000000000000000001111110001100001010
00001000010000010010010000010000011000001100001000000000110100000000010001001100101000000100000101010
11001110111000011100100010000001000000000001100010011000001000100100100010000010011010101010110011100
01000000011000010000001000001100110011110101000010001100010000100001000010001000011001010100100101000
01010010001000101000011000000000010000011000000110010100000000001110111011110000010001100000100100110
00110000000000000111000101011100000100100011001101010000000001101001010010000000001101000000000001000
00100001101000000010001000000011101000110010001000000001101000110101110010111000000010100000110011011
10000100000010001100000000000000010100000000000100001010110101100011100110011010010111001000001000110
10000010010001101000011000000100110101010000000011000000101000001100000000011001001000000100011000011
