00000000110100000100001100100110110010010110011001000000100100000110101001010000000010000000000000000
10000001001000101101010000000000000100010100110111001100001000110010010000000001000000000000001100000
00000001000001001100000000010000100010100000010000010110010000010000011000000001100000000001001000000
11010000001000000000101011010001000000010110010101100010000110001010000001000101101100001101001000100
00100100000000001100000000000001111000100001010000010000000001000100000000010010101010010100100011100
10101100010100010001001101010100000000001000000010010011000010100001111011010010001101111000011000100
10000100000000000100010000101001010000100000010000110000000000000011100101010011100000100101000101000
00000100110101010000001100000010010101011001001000101000000010101001000001000010100000011001010000011
11001001000001010010000101001010010110000000000100111100000000001000011001001001000001000000000100010
01100001000000000000001101001000010000000000000000000010010000011010001001111010000100011110100011010
00010000000010001010000000010010011000000011000010000110000000110100000000010000000010100100000011001
00010000000100001001000001100010010000000000011010000001010000000101000000000101001011110000000000000
00000001010100011001000000110011000110011010001100111010000010001000110111000001010000000000000000000
01000001111000100010010101001100111100000010100001001000000000000100000001010011100111101000000100000
00100101000000011001001100001000000010001000101100001010001101111000000000101001100100010100110101001
10010000110011000001000010001011100000000010100000000000000100010010010010100011000000010000001100000
00010010000000010000010101000100000000001100011000100101010001010000100010000111001000001000000010110
01011001100010010010100000000101100000000101001111000010010110010111111000011011010000001001000100010
00001010000011010000011001001011001000001001010001101011101000100010110010000000100000000000001000000
00010101101101011001010001000001001000100110000100110010000010000000100100000101000000010110100000000
10101010001100000001000000001000000010100110001000000000000110110111001011100000010100100010000001011
00101010010010010000001010000000000000010001010000000001000000100010001100010100000000101011001010001
10110000110000000011000001010111010100000100010000011000000010011010001001010000000000100100000000001
01100010001100110101000100000000001000101100100110000100001001001000011000010000010101110101010100010
00010010000000010000010000100000001100001000010010000000000011000001101001000110000010000100000010110
10000001001001101010000001000001001010010101100000011001000110001001000000110001000000000000100011100
00000000000011000010110000000010001000100101000111010010001101100100001000001001001000100100110001000
10001010110000100101001001011000110010100010000110101001111000001101001010111100000101100001101001000
00000000100101000010000001000001110111010001010000100000100011110110010100001011110101001010001000111
00011000000010000000110010001001000010000100100101000011001100101100000001001101100100110111110010000
11000010000000000111100010101011110001000010110000010001011100011010000010010100010000000111000001000
11011000111110000000010100000100010111000100000111010000001000001000000010011000000110011000011000000
01001011000000000001100000011000001000001110010001000000001100111111100101010000000010100000010000110
00000000001011000010100000010000001010010010000100010000000100000010000010000000000010000000000101001
00000110000110000100100110100001100111110001010000000000011000000111010010011100001110100000101111000
11100001010100000100100000001010101000000111000000010111011110000110100001100000100000010011011010100
01001000001011000011101110100101010000000001000000001100010101110000001110001000100000001001001000100
00000000010000000100000000001110110010101100010000001010110001011000100001000001010000000100000000010
00010010011000101000001110110010101011011000010000110010110000000000100000101101000100000000100001100
00110000000100011000000010000000011100000000000100111010001111010000010000000010010000111000000010001
01010010000000000110100011000000101001000110001000001000110011110001110000100001110000000000010010101
10000101000000011000001010011010100011000000010000010000100000101001001001110110000000100010010010001
00000001010011001010001000111101000100100000001010101001000001000000010000100001000010000000001111000
00101100011100000011100000001010000001011000010010101010110011010000000001000100000100000011101011000
00011010010110001001010000101001001001000010000110000000001010001001010000101100000000101000000010000
00101001111111011000100011000001100001000111001110011000001100000000100001011000100100001011010011000
10011100011000010101100000011001001000001000000000010000101110110000101010110001000000010101000100001
01001001010001101000000000000001010000000100000101000000100100110000000011000000011000011000000000000
00001010100100100000010111100010100100011001001000000100001000110011001000010010000000110000111101010
11010100011000000000000001000000000010000100010010000000011000000100110010111000000010101000000000000
10000010100000101011011000000100001100000010100011000000010100001000000000000000000001000000001010110
10100100001001000000010010000010000110111000110100010100100001010010000100100001000000000000010100100
00101100000101000001100100010000110101010001001000000110001000000010100001100001000000100010000100001
00000001010011100001111001001001010001000000100010000010000110001100000100011000101000000110010010011
10100010000000000001000000110000000001110011100000000000100100000000010001000011100001000011010010001
01001111110000100000010000000000101011010000100100001101000010000000101011000000110001000000100001000
01100011010001000010110010110000101001001010110000100100100010000010000100110000000000001010000100000
01110000101101000000100100000101010011000001000010100010110001100000000100110100000000010100001001010
10100100000000100111010000000010110010000000000100000001000111110000100100011000001101001010001001001
00000001111101011011001101010000001000000000010100000000000001000100001100110000001000000000100100001
01101010101000100000100000100000101110001000011111010000110100010000110100000000110010010001000000010
10010000010000101000011000010001010100010010010001000100000010100011011010111011000011110110000000000
10001000011101001010010000010110011001110000010011101000000100000010000000010000001100010000010000100
10000000010111100000100100100110000100000111110001000000000000000100001001000010000101110001011010000
01001000111010110000001001101001000000011110010100100011000011011000100000100100001101100011010100000
11100011001101101000010000000010101000000000000110000000010000000010010000000011001001000000000110100
10010110000100000000001011100000001010010100001001001000110111010110011000000100010101000000100000000
00010000001011100001100110010101010001010100101010100100001000001100000001010011001100000100001111001
00100100000010001000011000010000011100101100000100000000010101010001101001011000000001001111000001110
00000100010001000101111011000000011100100010010011010100010111111011011011111000001101000000000010011
01010001011110001000001010010001001010110001100110000100010001010000100111010011000000110001001110000
10110100000100001001010000010000000001000010010100101100000100100000000000001001000101000000010100011
00010001010101011010100101000001101010110100011000101001100001011000100000101010000000000001000100010
00010000100110000010001110100001000100100000101000000100010000111100100000000010110101001000010000001
10110000100000110000001000100101001000101010000100101010000001100100100010000100001010100000000000001
00110101000011000010000010000000001110000000010000000000000000000000001010000000000011000010001111101
10000011010110000101000111100101000000011000001000000000001000100001101001001100000110100100110110001
01001000001110000100001101000011100000000101110010001001000000000000100001011000100001000101001100101
00000001100101101010000100001010101000000000001100001100100000001101000000000010000000000000010100100
00110000100000110001000100000000000100001000000101100011001110000100010101000000000000000100001000111
00011001000000001001000000000011010000100001100000110010101111000000000000100010000001000100010000001
00000000010000000100000000100000101001000100100010110100110111000011011011001100010100100001100010101
10100000000110001000001000010111101000000000000100100110010000000000011001011000001000001100000010100
00000100000111101000101000010110000011011100011001000011110000000000010100010000001000111000000001100
00100010010101000000010100000101110000000110000011100000001100110010000011000110101000110000001000000
00000110100001101010000000000100110000000010100000000101000000010101110000010110100000000001000111100
00000000000111000010011100001100001011100011100101000100001000000101010010110000100000101100000100000
10001100010100100000010100000111100010000011101101101010110101010100101000111010010000100001000000000
01010000000000100000110000000001101101001000111000000000110000001001101000000101011001100000010010111
11000011001000001000110010000111100101000001001000000101010001001100000000101010010001001001010001000
01001000001000101001001000000111100010001001100010001000011011000011101110100100000000010011100100110
01000001000000010001000100000000110110110111010010110011100000100000011001110000111011010010100100010
11100000100000100001011000100101010011011000000000000001101000000000010000100000000000000000001000100
00011110010100010100000100000000000000000011101000010100000011000001101000001010001000001000000000000
01001000001000010000000010010001100111000000000000001100100001100010000001111101000100010000001000010
11000000110000100110010000110010110100010001000010000010010000001000110100010010110100000001010000010
00111001001010000110110000001001010000100110001000000101111000000001100000100101110000110000000001010
00010101000100010010000000000000011001010100000100101001000010110001111000100101000001000100001000101
11000000001000000001001001100011000001001110000001100000111101001001010010100000100000000001101000010
10010000000101011000011100001101000000000110100000000001010000000010000000000100100000110000100010010
10000000010010000000100100101010111000000000101000011101000000000100000110000000100100101011100000001
