00010000110000000000100000110010010100100000110000000001110010110010001011000011001000000000001110110
00001101000000111011000011100100001000000000000000111010000000100000000000111011011010000111110100011
01000000001000000110010000010001100001111000001101101111010000110011100010000100100000101010000110100
10000010001000001100111000000000000000011001010000001101000001000000100001100001000000011000010101010
00000001110100101101100000000001011100101010001110000001001000101011000010000001100000100000000000100
00000100110000000101100111010001101111100111000000010010010100000000010110110011111001000100010000000
00000110110100000100000000100101110000000101110000100000000000000010000011010001000000010000000000001
11001000110001000010001010001000001000000110000000001011001000010110001010000010000100000110000000001
00000100000010110001001010001000011111001010000000000100000000000100010010000000110010000101000000010
10100000000000111000110110010011001000001101001000000000000001000000010000000000000011000000110110101
11000101000000000110110010001100001010101010000001000001100010000100010001010000000110010110001000001
00000000000001000100100110010000001000001010000000010000100101101010100100100100000000001000001100000
00010100000010011110100000001110000101000000110111100001001000001010001100010101000110000100100001100
00010000001000100011000011000110001110001011011010010000001000001000101000100010100100000100000000000
00011000110000100000100001010001000100001110100000000010001100000001001111100000010000100100100010000
00000000000001101000001000101001100000000000000000111000111000001011000000010001000010001001000001011
10001100010111110100100001110010010010010010001100100110011110000000000100100010010010010000000001001
10000000010010001001001000010010010100010000000011010000110000101111110001010010000110000000101100001
01010100000100100101110001011010010001010001000000000100100001100010010000100000000101000000100010011
10110010000100110101000010101010100101011000000001110010110011110010000101100000001010010010001001010
01000001100010000000010000010101000110010011010000101110000001000001000001000010101100001010010000010
10000100010010100001000001000000100000101001000010101010101101000100001010001001000000100000111010100
11000100000111111010000010100000110111001011000100000010010000000110000111000011000010001010000100001
11011000001100001100001000010000000001101010111110000010000010000000000011000010010111000000001101000
01010001010000100000010101000101001101100001000100000100100010001000001000000101000101000100010001101
00001000110011111110000100010000100100110001000100001000010011100110101000011000010010000000101100010
10000010110000010100000101110000000010000110000100010100000110001010001010000000000000101101100100101
11110010010000001100000101101000001010101000101101000011100000100010010000100101100001100110101000011
00011000000000100000100101110100000000100000010011000100100010100100000000010110000000000011101000000
00010001100000000000000000000000000001000000100001010100000110000110111000000000000101000101101011100
11010000100000000011000001101011111100100001011001001000001100000100100001101001011101000010100101100
00110001001000010001000000100011000110111001001010000110100011000011111000001001100110000001100010000
01000110010000110000000010000010010100010110000101000100100110100001010000010110000101010001010000000
01100000000100000110000010010000110000000011100110010010000100100101100010001011101100000000000000100
11000010001000001000001001001000000110101000001001000000000000000111000001101011100101100100100101001
10001001111001011000001000000000000100011100011011100101100010000010011000110010010100100101000000100
01000001000011011101010000000000000000000110000100100110100001110001100000010000011000001001110110100
00001111000000010010101001010010001001000100000000111111111001010000101000000110110101000010011000100
00000001111001000000001010100000000110010100100001000101010001001100000010101100100010000000110010000
01001100000010101010010011000000111000101000000111000010000000101011100000001000001000110100101010010
00000100000110001000000001000000100010100010110111000001010010110101100000001100010001011000000010000
01000101010110110100100010100110110010000011000110010100110010000011000000001100001001010011011110000
10000000010001011100110011101000001010110000000001001010000010100000000000000100000010010000000001010
00000011001100001010000101001000000000100000110001100000001000001001100101010001000000100000000010000
10101100010100010000111000001000100000000110100100010000001101010000100001000100000100100101110101010
00000110110000001010000100000011000000000000001011001000010001100110000100001011100001010100010110110
10000000001000010101100001010011010010000001010100000010000010011110001100001101001000000100000011001
00010000101000010000010100100000000100000000000001010010000001100000010100100101000000001010100000011
01001001101100010110011000000010010001011100110101000111101010111010101001000000000000100100010000100
00101000010100110001010111011010100100000000100000100010000000000010101000000110010000000000000000001
00110100010010101011110010011100110011000111100011011010001101000000110011000110001001010101001100000
00101001001100001000001100001001000000001100001011000101110000000011110001010001100100001011100100010
00000101100001010000001010000001000000000000100111000000000010000001000001100000010010110100001000011
00000101000101101001000101000100000100000001000100000000011101000000001000000010101011000000000010101
10000100000000100110101000000000000110100000010000000001111101101100010001000010100011010000001101001
00001110100110011110010000000011011000100000101010110100100101100100101010010000110000001001000011111
00000010000100000000000011101000000001001110011001000100000010011000100010100000010000000111101000010
10000001110100000000000111000101110011001001010000101101101100100101011010000000000111011000001101100
11000001001000001000110000000001000001010000001100001111001000000000001010000000010000010000100000000
00011000001011101101000000001000010110001101000011000001000010000100010001000000100001010101010000000
00000001001000010000100000000010001000101000100001010100000010101000111000010010100000101100111000001
11001100111000000000100001110001011010001001001001010000000001000111000100000010000000011000001101110
01001010000001010100000000000100000000100110000000110100111100000000000010010001111001010000100010100
11000110010110010000001000001100000000100000010000010001010001101100110001010000000000110110000010100
10001010000000001000100010000000000000000110101110010000011000000111101100000001000110010100110100010
00000010000000010001000110010001100100000001100000100100011000101011010100101000100001000000000010101
00000000000000000011000010101011001010000000001011000001000111000001110010011010001110000001000010011
00010100000000101010001100011110011000100000101000101000000000010000000010001000100000000000000000010
01000000001111000111001100100000011010110011000010010000010110101100000101010101000000000101000010001
00110000110000000001000111001001100000000010001000000010000100001111001001100111010001101010000001110
00101100000000000000010001100011110011000001100010000000001000000000100000001000001000010100001010000
01101000001110001101000100010100000010000000000001000100110000000100010000000010011000010001101100010
10000001010000000000101010000001001001000110100010000101001101011111000000000000011000000100111001000
00000011100110111000000000010101100100010101000000010001111110011100110001001011000000010000000100010
10110011000100010000100000000011100010100100000010101000110000000010010000110011100001000111011010001
01101100001000000000000000011000010111001100001000010110101001100000000010010001110000100010001110000
10000001000001000011000010010100010001000000101010000000001100001001010000001000100101010010110100000
00011010100000000100000100000001011000111000000100010111000010000101000011000000001010011000000000000
00001000100000101100000101001010010000110010001011100100100000100100000000000010001000110000010000000
01001010000100000010110001010010000100100000011000010011011100101010000001101100111001111100000001010
10001000000000010001011000000100000001001010010000000100010001000100010001011001000100000001101010000
01001100100000010110000000000000010010000000000011100101010010000000010111000001111001100100000000001
01001100100001000010101001001110000010011011100100000010001000001100001000000100000000010000000001001
01010000001000010101010000000011010101100000001101010100100100100101001010001001110100000000000110100
00111101111000000011000001011000100100001101000001011101010000000100000000000100110100110100101101010
10001001100011000010010000100010001000111010011000100011100000111011100011001010000101100100110010000
00000110000001101001000000100000100000100101001010010111001100011110000011001000100001010000000000010
01000110000000010001100000100101100010000010010101001001110000110000000000100110010100000100101101000
00000111110011000101000100110101101000000001011100100000000000010110000000100010000110000100110110110
11110000011001000100010000000000000100000010100010001101000110101010000101011000000011010000000110000
01001001111000000000000000010000001100000001100100111010000010010001011000100000010000001110000001010
01011100000010010000010010000001000001100100000010001000010100100000000100000000000111010001001000010
00010000010101000010100100101000100100000101101010010000101101100110001000000001000000100011111000010
01010001001001110000100100001000000000101101110000000010101000110100001000011000000010010100111011000
00010010001000000100010011000011111100110010001000001000100010010010001100000111000000000000001000000
00000100011000101000001100100000000000000011100000100011000000000010010010001001010001000111000101001
01000001100100000101110001000000000001000000001111000001010010001000000110100001101100000001001100000
10101000010000010000000101001010101110100010011101000000011001100000001110010010000100110110001001000
01100000011110110000001100100110101011000100111110010001100000101000000000000000000000111000010000010
00000011010100010000100101000001110010001100010100011000000100001000101110000000001000111101110110010
00100011000000101000000100101001010001010011101000000110010001000000010010000000110101000010110111101
