01000100000100010110000101001011011101000000001000010100100101000000000000010111000100010000001000000
01001000000100000010100101100001010001100000100000010110100111001000101000001000000000000100011000001
00100001010001100000000000010000001000110001111110000110001010001000000110010000001110000110000000010
00010100101001100010000000000010010100001110110101000100000110000000111000101110001010000100001011101
10000001010001100100000010100100010100000101110000000001000000000011100100000000010000100100110001001
01000010100100000110100110000001100100011100000010000000010000011011100101000011000100011011010000100
11000000011010010001000110000101000001001100000000010001000000110000001010000010101000110001100100110
00010010001000010100111010000011000000000101010010100001010010000001101000001110100110000100111000011
00000100001000001111001000010010101010010110000000011001001011100000001001100000001100110100001001000
00000000010101101010000101100000011001000110000100110000011010000001100010110001100000100100010100000
11101000001000011000000000001011000110100100001011001010010100000101001100000001001000010001000000011
10100000010010000000000010000110111000100010100101011011100000110110001001100000010110111100011000010
00110100010001100101100000010000100100100000101000100001010000110010000100100000100000001011000000001
10101000111000100010000000100001010100100011001011100000000010001000001001101011101100001000000001010
00100100000000000000100100111100110111001001010010001010010000000011010111001000010000010000110000010
01101000011000100100000010010000010000100010010010000000100000011110100000100000011000101010000010000
00001000000000011111100000001111000001110001000001000100010110000100000000101010000000001001000010011
00100001010010001110110000000010001010000000001000000000000011000010000100100000010010000010011000110
01000000000010100001001001000100100000001100000001000110000110010101010001110000110100000000100101100
01100000001001101001000011100000000001000100000100001010110100000110011110000010101110001000111110001
10010111011100000010001000101011001110100001001000000000000100100010010000000000100001101001100100101
11110101110100001101000001110101010010011000000001000000000001000011000000000110000000001100001000100
11010100000100001011100001000001010011111000000000000100010100010001001100000001100110000000010000100
00000100101000100000110100011010000001000000011010100010000000010001000011100100000000010110001101010
00100101010011000101000000000001110010000100100000000000000011101000000000001101000100000101000010000
10110011101001010001101000010000101100110001101000100010100001010001010000000100000000011000010110001
00010000011110010001101000011000001110001100011110000000001011010100000110101010000000000001000011011
01100000110011100101010101011110100001100000000011111000100000000010010000000001101001001100110110001
01001100000001010000010011011010000001100000001011010000001001011000011000000010010100000000100000100
00010101001000010100110000000011011000001001010100100101101011000000010000010100100001010000101011100
01100000000000001000000000110100000010000000100000101001001000011010100011000110000101000011010100000
10011100110000001000010000011000000101010100000010100000100101101010001100010100100001001100100100000
01000111101100010000011111110000001111100000000000001001000100111001000001011001000000001000000011110
00010110100000010010000001101000011011000000001000100000010000000000110001000110011000100010010000011
10100000000010100110000001100011100000000000100011001101001000010100110100000000001000100001000100100
01011100010000110000000100000110001000010110000010010010001000000000000000110010000011000001000010010
00000010001000000100010000001000001001010000101000000100000100011111000001001000100011011000010010000
10110100000001000000000000101001010100001000000100100101010011001100000011000000100011011011010100001
01010001010001000100000000000101010001100100001001000001000001010101001000000001000010110001100100110
01000110010101000001000100001001100000010011101000001100100000001000011001101010000000001100000001000
01000111000100000100100010010001001100000100010000011000100100001110000100000010111001101000010000101
10001000000010001010000100100000010011110100010000000000011001000000000001000001001001001100100001000
10010101101010000000010100010000100110001000101000110001110110000001100010000101100110000010100000010
00111000001100000000001000000101101001001011110000010000000000000000000001000110001001100001000100001
01100100000000010010100010100010100000000000000010000100011000000100010111000000111001000001000000100
01010100001010111101101110000000000100010001001000010010101000001100100110000000000010010011001000100
01000000000000001000010010000000010111000010000000000010001000000100010101110110100110001000000000010
00100000010010101001011010111011000110110010011010001010111001000100000001011100000000001001110000101
00000000000100000001000010000010000100001001000101100001111010100000010000000000000110000100000110010
00100001000010010010010100001001101000001101011010001111010001001001001010100110000100110010001010011
00110001000010000100000010011011000111000000000100010000000000001100100101000111001001001000000100001
00000001000000000001000000101101000000000000001000010101011010010100000000100001000111101101010000001
00010000100001001000000001001001001000011001000100110010011010000000000000001000001010000100110000011
10100000010000000010000010110000010100010000100001100000000001110001010010010000110000000101000000100
00000101010110001101000100000011100000100000001111010100100100100110000011001100010001101001001001000
11001001001000101001000100101000101100101000000011100110000110010000000010010011010111001101000000001
00000101001000000101100000000100000100010011100100001000000011000100111001000010100000101011000011101
01000100000100101010000010110101000001010100000000010000110101000001100001010101000000110001001100000
11111011001101001100010100110100101000100010001100111010010010010101000000000100000010011001100110011
01100010001010010001100001000000101100000011000000000000000100001000001011010001000110000000011001010
01000010000010110000101001000110100000101001100000001101001000010010001010000100101000100000001100000
00110000000010100100000010010010010010100010110010010000000011000000100000100010110100000001000001000
01000101000010010000000010001100100001100011000111001110000011001000010011100110011010101000111110001
00100001110011000101101000010000110100001100000010010011010010100110000000000001100000000001000000111
10000000100011000010100001000101100100001000001010010010100000010000111000000000011101000000000010000
10000000011010000000110100000010100100001101010001000000010001000000100000001100001001010110100000110
00101000010000000100000010111110110010101000000101010000000011100000110011000101100001001000111100001
00100100001100100001110000000001001000000110111111000010000010001010100001000010010100011101010100001
01011010000011000000100001001000101100000010100000101000000111010011001010100011100001000100000010100
10010000000010101001100010010001101000111000001011001110010001001000001000110010000000001000000001000
00100100101010110000000100100100000000101000010000000000000011011110111100000011000000110010000110100
00100010000000000010010001100000000000001010110010000000000101000100101000010100000000001000000001001
00000100000100000000001000000011101010010000000100010001000000100000100100100000000001001011110110000
00000100000011000001000100100010100101000000010000000001000010010010000010000100100100000010000110000
00000010000000010110000000110001010000000000110001000001000100101110110000010001110000001011110001010
01111110000100000010100001001010010011011011100001000100101001000110101101100000011110101100111100000
00011100000100001110001100100100001000100000000000110100111100101001000010100011010010100001100000100
01011000111001011010000000000000000111000001000101000010100110000110010001000000000111010000000011010
01100000000000000000101001010011000010011001100100010101000001000100011010100010000010100111100010000
00000001000000100111000001000001100101000010000001010011011001000100000101100000000100110101010110011
00000010000111000000000000000100000100010000101000001000101000100010010000011010001010001010010100011
01001000100011100000010001000000011000011000110001100000011001000000010001010000000001010001100000000
00001010111010000111011000000010000000000000000011110100010001110000011000100100001010001010000111001
10010011101010010110010000010000010010100010000010000010000100010010011100000010000010000000010100001
10011001000011000110000000000111010001010000010101011100010000000110011100010000000101010010011100110
00000000000000010100100100010010100111000000101101110000011100010000001010010000101110100000100001010
01001101010000000000110110000110000011010010000000100100001010111111110000101000011100000101000000100
01111100000111100000011111001000110110000011000000010001000100001000011000100100000110001000100000000
00000010000010100010011100110011011000011001100101010011000100101100100100001101000001001100110100110
10000100100001000001001100000000100001010000111110000110101001000100011000100000000110000000011000000
10000110010000000001000100110000000101100000000000000011110000110001100100100001101011000101100100000
00000000000010001010000000010100000000010000000101001100010000010001001100000101000000100000100000001
01100000100100000100001000100110001001110010010010100000001000010001000000000001110100010001111010000
01100010010000100000000010001100100100000000000000000001101100000100000000000011000100000101100010100
00011011100010110000010101011010100010010000001000001000001000100100100001000111100000111100000001100
00000000001010010001001010001010000000010010000000110000010001010000111000101000010000010000010001000
01000011100010110001010001010101010000111101010001001100110111000100000100000011000011000000100000000
10010100100000000100000100001001110000010101010010100000010101111000000010000100100000110000100000100
11001101010011000100011001001000100000101000110110000100000010100110000010100000001101101110001010001
00000011000000010000000100100001001000110101000000100101100110000000011000001100110000010010001001000
01000110110100101100100101000110000010100000110001100101011100000000110000110000110011010100000100000
