00100010110010001100000111100111100001000110101101000000001001010001000000000000000010000100111010000
01100000010010010000100000111000001000100100010100000011000010011000011000000000010001001010101000000
00001000000100000100000000001000000001000000000000010001000110011000001011000100100101110010101000100
10010000000000000101100000000010101100011001001000000010001110110000001001111111010110000000011000010
00010000010101101000100001101000100010001000001000010011000110010110000110000000110101001110100010010
00010000110000000000010000000100010000100100001010000010000000101100110100000010001001000101100000010
00001001100011101000011000100010000101010110100000111000001010110000010010001010101010100010010010001
10010011110100111100000000101001101011110000101010010010101000100000000000001000110010001000000010101
00101011000000110010010101110000000100001000000111001100001010010001000101001001100101001000100001111
00010001000010001000000000010100001010101101001000000100110001011100000100100010101010000100000000100
00100100000010000000000011011000000100000010001110100110111000001000000010001010100000000000001000001
00001000100001000010001100000000000011100010001110000110000101000000000011110000011001001000110111001
10000000000001000110100000111101010100010000010000000000110111011100000010000100110100000000100011101
01000001000101000110111111000100001110100010001011100001000000010110001110000001100011000011101000000
00100110001000000000000011101110000010001101000001001110001000000000100110000010100110000010000000010
00110000101100101000001000000000000001111000100010000000001011000000100001001001011101100000011000000
00011100000000000001000010011000010100001110011000110011010000000101010000001000000000000001000010100
00110101011100100000100100011101000101101100001101001100010101110000100010000000100011010000000000010
11110000101010011010001010000001100001011010111010000010001000000001010110011100000010010110010010000
01110010100010100100100001000000101010000111110000000010001100101101100000000000000000100000110110100
00001010100000101010001000010000010010101001011100011000001001001100010000000000000010111000000000000
10010000000000000111101101000100000010000001100010001000011010000000100010000100101101000101101000000
00000000010001100000010110001100110000010001010011011000011000000010110010010000001000000010001000110
00110001011100001010000001100111000000010000010001000100110100100000000000100011110000100011000001101
01010001000000000000100001111110010100111011100001000000010000000000001100001011001100000000010101100
10001010100000100000100011000110000100100000000010001100011001001000010101111000000000000100001000000
01111000010000000100001110000001000000000001001100011000100001000000000000000000000100001000010001100
00010000001011101001100100100110101000100101000000000000000011011010101010000000000100001010010001000
11010000001101100101001101000000100000101010011000000100101100010001001000000001000001000000100000001
01000010001000010010010011100000000000010100101101100000001101000100000000010100111001010100001011010
01100000100000000001100000001000000000000010011000000000000110010010010010000000001101000100001000000
10010101010100000010100001001000000000010010101110001010000010001100100100001000100101100000010100000
10000010001010001010001011100100111000000010001000011100010001001010000100101011101100100010001010010
11010001011000011000100000101101110110010000100000100010100100010010100100110100010100000010000010010
01010000000000100001100101001000001110001000001000000000001101000001101010100000000010101000011110010
01001000100010000110011011000000010000000000100101100000000100110010000000111001010010100010101100110
01000000100010000001101010111001110000000000110010000011000100010000100010001100100011110100010000010
01000000000000001100100101000010001000100000000111110010100000010000100110010100010000000000101010100
01000100001101000000011100000000011010010000010101010110000000010000011100000110010000100000101000100
11111010000010100000001111100010001010000001000100011000110101000001000000101100001100000010101010000
01001110010101000000101100000000001101000000000000000001000000101000001000000000001000000010001000111
00000011000000100010000101001110011100000100110010010000000000111000100110100100000011000000000101100
01011110101000110000100100100100100010000001000000000100100000011010000000000101001001000100010011100
10100001110100100010000010100000010000000011010000010100000010010100001010000000000110000101011000000
10000010010001000100100010000100110000000000001010100001001000110010000000100001010100100000110000000
11110000101101000000000000001010111110101111010000000100101000011000010010000100100101100011100100010
11100100100010000001101001100000000001001100100000001000000011001000011000000010000100000010000100100
00101000010010010011000000000100101011011000100011000010001100000010001000010001000000010010111010000
00011010010100001000000010000000100100001001000000010100111001100000000000000011001000000110001000010
00000100010010010000010000000011110110001001000100000011000000010001001010010100000000011110001000100
00011000000011000110000000001000100000001010000000101000011001010001000000000000000100100001101001100
00111101000001011100010000010011101001100000100000000010001000000000001000010110000000000000000101110
11101001000100000001010000001010000100000100111011000100110010001100100100001001001001001010000110001
11001000010011001100010000000010000011000000111000011000100100000010100010001011011000100000100101110
10001001100001000100110000000010000000010001101000001000101000000000011000010101000011101100100010100
10000011001000010000000000110000101100100000011010100011000010001001000101101100100100000000000110101
01010011000010000001000000110011000010100000111000010000000000001000100000000010000000001100100001000
10111000000000000010000000000011010000010001101000001010001010100001000110000111010000100101111000001
11000000000001010000100100000000000000000000110001000111001100100110000011000010111011100101010001010
10100000010010111010000100000000110011101011010000000000011001110001101000000001100000000000010001100
00100000100110010001010110011011100000001000100000010000100000000110001100100000000001001011101000000
10010000110000001000000000001000000100100000101001000110100000000111111100000111000001111011010000001
00110001001100100100101001000011011000000111010101001001010001000000000100000000010000000000001000110
10010001110001010000110001001000110100000001101111100000001000010010100000000010101011001010101000110
10010000000000000110100001111001100000100000000100001000011000000001101000010000010000010111000001110
10110111001000001001000000010000110001110100000001001000100100010100001000010000001010011011101000000
00000001000000000010001000011110111001000000110000000100000000000010010001000100000000100110001000010
01001001001011001010100000000001001100011010111010100000000101110100000000000000010101001010000001000
01000000001000101000000101000000010011001000001000000000011101010000110101001011010011010001011100011
01000000001000010010010001001100000000000000010100010000101001010010100010000000110000101100010011010
11000100100001000000000100000110001110100001001001001000001000000100000000001000001000010100100000101
01011101010101101011100000011100000100000100010000100110001010011000000000000000001001100010100110100
10000010000101001100000001101100000000001101000000100000010001011000001000000010000001000110101001110
00000011000000011101000100000100000000001000000110001000001100010001000001100100100001000100010001001
10000000110100000000000010000001001100100000000100001011001010001000000010000000000100000011100110000
01000010000000000000000100110000000101000001010000000001000010001100000001000000101001100000010000111
11000100000000010101000000001100001100000010010100100110011000000010000001000000000001000001011000000
11100000000100000010100001000111010101000100010011010000000101000001000000011000000100001100011101010
01000001000000010001001001010001010000000011000000000111000010001100000101011110100000001000001000000
10001000000100100001000000010101010101000000001101000010100010000000001010001000001000000100010001100
01010010011010101100100110010001000000101001010010000000101000011010000000000010001100100100001000011
01001000001100010000010010000000000000000011000110110111011000000000000101000110000000000010010011000
11000000010100100101010001000000110100100000010110001100011111010001101101000110000100010001000010010
00000011001000000101100001000011001110000001000001000101100001000000000000110000000000000100101001010
01000000001000100000001000100010000000010100010000011001000000010001000100100110110000100001010100010
00101001000100001010010000101111010010000000010100100100000000000000100001011000011011010001100000111
10001100100000000000010101011000100100110011100101010000010010111110001010010100110100110001000001010
01000000010110100000000100011100000100010010001100010000000010000000110100000010000100100011011000111
00000010011000010110000010110100000100101101101010001000000010001100010100100000000010000001011101100
00010010010100101000101100001010010000100011000111111101110000001101101001001101011101000010110000110
01011000010001100000000000111000001010001001000000101001100001110110101101100000010110000011110000101
00010110001001000001001000000000001001000000000000010000011100010100000000100001011100000110000100111
00001100000100000110010001011000011000110000000000001000110110100000011000000001000110100001000000101
00100010000011011000100000000000001101010111000000100010001110000010001001000000010000110100000000101
00000100010000010100010000000110001010000100010000011101010000000011101110000100000000010010000000000
10010110100101100010100100101001101000100100010100111101000011100000101100100001001100001000101010010
10010011101010111010010100000110011110010000010001010000000100101000000001000000000010000010000010010
01100010000010011100000000001000100100000110001000000110010001000000101000101011000100100000001100000
00000000000010000000110111111000010000010000000000010111010000011000011010001000000000000001000110111
11101000000010000000000000000000100000000011101000101000101000010000000010000000000100100001001010100
01000000101110000010001000010010011100110010001001100011100000100000000100001111000010011000000000001
