00101010001000000000001100100010000000000001000010010000000101000100100010000100110000011001100000010
00000000001001001000000000010110010010010000000010100011001100010001111010000110101111100001001000000
11000000000101000110100100000000010000100000100100001000101011101110110010001110000110011010100001010
01000000010010001010001010001010000000100110000010010000100010100000110000001000000110000100010010000
00000001000111101011010111010000000100100000011100111011100010101010110110000011010100001000001000011
00110101000000001100100001000001001000000011010011000000000000011001000011101010010110100010000010000
00000000000100101010110001000101000100110000110000100100100100011001101011100010110000001000110010011
00101000001010010010100100001001010000010000010101010000010000001011000100000000110000100000000010000
00000000000010000000001111000000010010000010100000001010000000011001101110010101100100000001100000100
00000101000010010000011100101001100101010000011100000100000010000110010000000111000100001001110111011
11011100011101000100010001001000001000000101010000000000001100000000000001000001000010100100001010010
00100110110100100000001000001000000000001010001011000011010001110000000000001001110000000110100001010
00000010000011010000010000001001101110000010000000000100000000000111010101100100000001101011011001001
10100010010110000001010010001100000000100011001001100100100100000001100010110000011000000001011000011
10011000011010000010010001000010000100000001000010011000000101000100100000110011011010010000100001001
10010100100100110000110001010100100000000110100000101100010000101001001101101011000000000010010100000
00000000000000001110101011000110010000001101000100100000000100000000001010100001000011001001011001000
10000001000010001101100110110101011000000110000001100010101000010000000001001101000100000001000011011
01010000010000001010000000001010100000000000000100100110000100000101010100010000110010000000101100010
00001110011010110000000111000110100010000110000100000001110100100000010100110100000100000100100111000
00000000011001000000000010001000010010000001100000000001001000100000101000000100110010110000001100000
00000001010000010100001000000100001000001000000010100010110111010010100100010111000111000000000001100
00101000000000001001111000100100111000000100000000100100010101000011001010010100100111000100010000001
11000001000000000110000010100010001000100001000000000101110001110110000110010011001000011100001000000
10001011000000111001011000000011001000100001000000000000011010000100000000001010000001010000110010111
00001111001000111000000100010000010100001000011100011000011100000100010010111001011000100000101000000
10100001100101001000001010100010000011000110111010010100000000101001100000100100000000000000110010000
00011010100100001001100100000001011000010000111001100001001000000110010100000010000010000001000001101
00100000000000101000001100000001010000100100001100001010100010100001100000000110000010100001000000000
00110010010011010101110001110100100000011100001010100000100011100110011000000100010000001001000001000
01100011000101000011010001000110000100010000001010000000000101000010000011010101010000010010000001000
00010000011010010000001000000001100000011010000000100010000000000000001000010101010010000010000010000
01001101010100100100011000000010010001000010001011000001111011111010000000000001010100101101000000000
00010010000001000000100000100000110011011001111011100000001001001011110000000100101110101000010011011
11000000101110001010010001010000010010000101000000110000001010010100110110001000010001101000110100100
00010010000001000100101000100011001000000000000100010010000100001010000000010000100000000001000101000
00001001010000001110110000000101100000000100011000001011000110110101010000000001000000101100001110000
11101111001010011001001100000100000000000001100110001000100011110100101010000001000000010000001011011
00011001101100001100100100010010101011001101011010000001110100110010110100001010110101000101011001001
01001110101100001100001011000010100010001001010001000100010100111010100000011110010001000010010000110
10110110001110011001000100111100001100000110001100110110111001000000001001110000000000000100010000010
00010100000001001111000001100010011011100000100100101010101000001000011110111000001100100011000010100
01001010000101100000000010010110000011100000000000001010111000100110000100000010100010001010100000001
00100000100100100100000000101010010000000010001110000101001000000101001011001000100000100001000010001
10011100111000101010100010000000000000001000101101000000010000100010010000000000001011000100011100000
00011000001110001011000000101000111100000100100110001100000010010101000110011100010010001101100001000
01110001101000100000000000000000001110000110011010000010000111000001001000111000010101000110000010100
10000001100101001001000000111001000111000100011100010000000010010100100000001001011100010000100000100
00001010000100100000000000000100110001010001001000100000111101110010010000010010101000100000001010000
00000000000000100001101000100010010001100001100001000110000000000000000010000100000000010010001111000
00110100000000010000011010000000001000001001010001001110010000100100000000100000101110000111000001100
00011011010100100001011000011000100011000100010010001010001010110001101000011001110000010100010000000
01000000001000101001100100001010101000000100000000010001010000111000001111100001100000000010000001000
11010000000000000000000100000100010000000100011101000011000001011000000100100010000110110000000000100
00000101000000010001010000110100000001101011010000100100000000000100100101001100100001001110000000000
01110001000000100001010000011001000011000000000000001011001001001010101001000010000101010000000000001
10100000000100000100000000100000011000011011000000000100000100111000100100001000000000000010010010000
00001001110001010011100100111100010000001000000110100000000000000000000000111000011001001001010000111
01000011000000000110000000100101000001100000000001000011010001010000010000110011000001000000000100111
10000011100110100001000100011000000010000101001101000001111001011000000000111001010000000110101000000
00010001000010100101000011100011001000001100001000001100000000100101000000010100100000000100001000000
00000000000001001000000001000000000000110000000000110001101000000101000110011010000110000100001100001
01000011100101100101010010000100001100000001000001100010100001001101110110000010010011101001000101000
10010010001001100100101001000000010000000000111100000010000000001000000000100100000000000011000000000
01010000100010001001000001110011000111101000010000000001100000011000110000010001110111100000110000010
10000110000010011001000001001001011000001100000000000001101000000111010000001000101100000000101001001
00111000100011001010101010000001000001011000001010000000111010001000100000000000001000001001111001110
01101000101110010000001100000000001011000000100000100010000001101100000000010010100000000000000100011
00111011000011000000001000100001000110001001000000000011000001000011101000010000110000110110100000010
01000000010000110001000000001110000000101000001000010111100000000010101000010111100010010000110011100
00010000100000000110010100000110010101010100000011100001011101000110000010000111001000000010010010011
11000100010100000110010101000000000011000000111000000000110101111101000011000101011000001000010000010
01000110001000001001100000001101000100000000100101000011000100001001000000011100000011000010100001010
10100100001000001000000000010000000000010110010000010100001101010010100011100000100000001010110010111
00010000011100110010101010110001000000000010001000011001000100000000000000100101000000000000000000100
00011000010000011000011001000011111010111001100010010011000001000000110000110100000111011000010010000
00010000010101000000011110000000000001100001011000000000000100000000011000000011000100100000100000001
11010000100000100000011001101100010011011001110001001010001101101010100100100000000001101010010000000
01000110001110001001000101001000000000000100001101101010000000000000001101000000111000010000000001001
01100001000010000101001001000010010010010010000000110110010001101010000000001000100001010011011000011
11101000001011001000000001000000000101001100010000000000010010001001100010000100000100100011001000010
10010000001000001010010000110010101000101100000110010101101000100001101100110010100010100001000000000
01001001100010000101010000001001100100000001001100100101010101000010000100000100100000000110000001000
00000100110101010000100000111101010010011000000100010001000000000010000000010000000001000011100100100
00111001001100000001000000000010100010010110100100000011100000000100000000010110000110100000011100000
00000100100000001110000011001100000000100000100111000100001000110100010000000011100000001100010000001
00011011010101101110000011110000100101101010000110010101000000000100111000010110000000100000100011101
01000000010011110001100001001101001000000010100000000010000000001000100101001001100010001001000100100
10110000100001110000100110000001000000010111011000000000000000010010110100001000000101001011100000110
00001100010100101001010100000110010100000110000100100010010010100100000000000100101001000011011100110
00100100000100010010000000000000001000110110011000001001010101000001011100111010000000000000001000010
01100000010000000001100000101110101110100100000011101001110101111001100000000100010000011101000101000
00110011000100100010100011001010000001010000010110001010111001000000000001000001101110011011000001100
01111000000001100001100001001000101011000000000110000100001000000111101011100101010100111010000000000
00000010001100000111010000011011010000101001000000000011101101001010001100000110101100000001000101000
00000111010000000010001110100010101101110010000010001000000000010101000000000100000100000100000100000
00010000001000101101001110011111010100001010001001011001110001101101000100000100000010000010011010001
01000000001010010010011100000000010001110011010000001101001000110000011010010000000000000010100001000
10000000111100000000001110011000010000011100000001000001001000110000000000100000010001000000011000100
00000000000101010000100110000110001011010000100111000100001100100100000011100010000100101000110011010
11010001000100000101000110100100001010010001010000001000001000000001001101100000010010000100000001011
