00000101001000010010000001000000011000001001010000100001000101000101000101100010000000000010110101011
00000110000000010000010000010001000010010010011000111100001001010000000011011100000000010101000000000
01101011011000001010000011001110000001000000001001110000010001011101011000111100100110011000010000010
00111000000011111101000011011001100101101111000000010111010000111101101000000000000001000010001011001
00010010010001000111100110000100101000100111000011001010000011011010000000101000110010101000010000100
00000001110100110001111001000000101000101000001000001000000000000000000110010000000000001100110001000
00010000000011010001101011000100010111000100011001000000010011100000111111000000001010010011011100000
00000110010001110000110001100000000100010000010100001000011010010010101011101000000100101000010110010
01011100000000000000001011000011000000010000010000000000100100010000100000000000000000000101010101000
00000010000001011000000000000000010000100110100100000001100000010000000001010110001001000000010101100
10000000100010000000001000010000000000110001010100000011000000000000000001000000011000000000000111010
01001000001011000000000000100010010000010010010010000000010000001000000010010001000000000111000001000
00000010000000000000000000100000000010010001010101010000000100000000100111100011010010100011010101010
01001001001100010010000110001110010100000011001110101000101101000001000001001000000000010110010000101
00011001100011100000000001000110010000011000100001001000100111010001001010000000010000011100001110100
10000110000000001000001010000000000100000000100100000101001011000000000001000101000100000000101001010
01001010000001000011010001010000010000010001000011011100111010100000001011010000101001101001000110101
01000100100110101101011000110011000001001001000001010000011101000111000101101010100000110010000010110
01100010100100000000001001000110011000100000100010000010000100100001000100010000100001100111101001000
00010101100011000101100110001101000001000000000001110100000100010000001001100111100100111110100010000
00101101010000010100111110001010000011000001010001010011011000011010000000000100110001000100001100000
00100000100100100010101001000010001100010100011010010000100000001110110010111000100000100000000110100
10010100000000011011100001000101100110001100010001010001001001010110000110010010000000001111001100000
11100010100000000000000000010100010001000000011000000110001000100000001100010000010111001100011101000
10010010111000000101000000001101011010000100011110010000010100100110111000100111010011000001100000110
00000100000001001000100100000010100110010011010000100011001100101010000000000101001100000101100011100
10010000000100100100010100000000011100001010111100000100001101001101000100111100000000001100010100010
10110010000100000001100000100001100100100001101010001001110001000010101100100011100000000000100100110
00010000100011010000000000001000000000001000000011010100101011011011010001001100100110000101100000000
00100000000000000111000010010100010110010000110011000000001000001010111100001110000000000101011011010
00110000101010100100000010010000101100010010001011100101000100001100000000001000000111001001000001000
00000011100001000010001100010000001000010010000110000000000000100001000010000000000100001100111000000
00000001100001000010000010110010001100010100101010000011010101101010101101000001001000101010011000000
10001001001100001000100101000101000000100100010100011000000001000010100001000100001000100011000000011
01100000011010000100100011110000001000010000010001000000110100100000000000101100000000000110001010000
00100000000001010001000001001001000100100100010011000000000001110001011110000011000000110010100010000
10000000010110000000010000011110100110010100001000000000100001000100000100100001010100010100100001010
00100100010111100000000010100000000100000000111100000001001000001011100001001000000100000000001010000
00010000100000011110011011011010011100100001000000000001001001011101001001010000100000101110010100100
00000100011010100011010001110000000000000010011100001010000011011100010100100010100010011101110000111
00000001100010110000011011000010010001101010001101000001101110001100100010010100100000000110100100011
10000100000010010100000111000100010010101100001110000000000000000001001111110000101000100000000010010
01100011001011001111010011100000001001000010000000111010001101010010000001001010000000000001010000000
01110000000110000100100001000000010010000011101000100001001000110010000000000100010010100010100001101
10010001000010000001110000010000101000010001000011000000000000001001010001000110110010000100110010010
00010100010000000101110100100010000101110010001110000010011000100100000000001010000011011011010001000
00000100100100001010000010101111001100000011101010000000001101001000111100000010000000110001010100000
01001000000000000001000001110001100010100010101000010110010000001001011000110010000010100001011000000
10011000001101010000010010000100010000100000000011010100000001010111000100001001001000001001000001000
00000010000011001010001101110111110000101001010000000010000111000001000011111001010110000100000000000
00101010000001111110000001000100100010010100000100000000100000110001001000001000000001010001000000000
00110001001110000001000000011100000000000010011111001100110000001010010110001000010000000100001001001
01001000010000000000000000100000011000010000001000010010110001011100110101001110001000110001001111100
00000010000100001000011000000000000000111110010001011110010100110010010001110100001010101010100000001
10111000000000100011000001000100001010100011100000000110000000000010100011101110000001011000000010000
00000011100100001000000001000010100001010100000000000100100100000110010000111110101110101001110101100
11000100010010001000010011001000010000100000100110001001111001010000001010000011010010100010111101000
00101000010011001000000001000000000001000011100000111111111100000110001011000000000101000010000011111
11000001111000111100001000011001010001111111000101001100000100101111110110001000010000011000000000000
00001100001000000100111000000001010000001110000001101100011000000000010000010000101100000000010001000
11000000000000100000100010000011000110011000000010110100000100101000000000000000010000110111000100000
10000010000000111100010011100000000001001011000100100001100101001000000110101011000000000000100001000
11000000000000001010010000101011000000011000100100000100000001000100011000010000000101101100000000011
00000001000111010000000000110111100011000100111010010010010101000100000110011101010000001000100100101
00001011001110110110000000001000000011010110100000001101100000010110000000111000000001001111100000000
00100000011000011010001111011000010000101110110100100110100010000101001100001001000011000110000000100
10010010000010100000000010011000000010010000010000000000000000011000100001110000000100001001001000001
01100111001010100010000000000101001011000010100000010101000101001000010010100000000001101010011001010
11101000100100011001001000000000000000101011010010100000100101011100100001001000010000100101000000001
01010000000001000010000011100001000001011001111100000000001100000000100100000110001000011001100000100
10000001001000101001110001101000000000000000000000000001100000000000000000000100000001000001100000010
01001011100000110010011010001111100000001010001010110111000100000001000111001000101110110001001100010
00000110000101000000100010000000100100000010010000110011001100000110010100010001000000100011100001101
00101001000100100010100101001100000000100101001111000011010011000110000100010001000000110100100100010
01010010010000001001011000001010011111000000000110110011101100001010011111010100010110010000011000000
00000010000000100001000000001010110001000010001000000000010101101000000000000110000000000000000001000
10000000010000100010101110010000001010000110110011010000000010000100000100010100001001010000000000000
01011000010101000100000010011010011000100000100000111000001000101100000001100100100001110011101010010
00001000000000001000100001010000000001010100010100000100000000000001000000100100010001000010011100000
10100110111001110100000011011010000011010101000000101011001100001000001101100001101010001000010110000
01110000000000010010100000101010001001011110001100000001010001000110110011011111100001000010001110001
10000010000110101100000111101100011010000010000000000100001100011010100010101000100001000000100000011
00110001000100000000000000001011001101001010100111001011010100001000000000010101010010000000100011001
01000100011001100000010000001000110011000011110011010110001000000101100011000010111000010000011001010
00000010000101100000000000000000000000010010010010011000010001101111111110011000010000001000101010110
00001000011001100001000111001100101010100100110111100001100101100010101000100101100110010100111000011
00101100010000000110001000100010100000000011000000000001001010100000100100000001000011101001001000101
00010100000101110010000001110000001001111000000100001101001000000011011110110100000010001011010001100
00000011100010100001001100001000000001000010000101010001101000010100000100100010001000101000011100010
10010100101000100110000001001101000000011010001001000100000010100000100110110000110111000000000100001
10100011100100000100010100001100100000011010000011000111101111100100001000001000001010000000100000001
00011001100000001011000101000010101000001000111010110011010000000000001100001010010011010000010101001
11011100010001100000000000000000100110100011001010000000011000110100100010100000001010000001011100101
00100000100000101000011000010001000011100111000000000101000001001100001000001100001110011001010000010
01100100101000000010000000000010010000000011000100000000000110000000000100000001000111010000001000111
01000000100000101001000000100100110100000000010010010000010000100000100000000000011011000010000000101
00000101100010100001111100010110000010001010000000010101000000010010001101000001000011101110010010101
00000000000100000000011000000000010001000000110010000101011000001011000010000000000000101110000000100
11101100011100101100101011000111001010010100000100000100110100010000010000010110010001001010001000111
01100000001000001000110000000100110100001000000011001000001001001001001000101011000100110101000000100
10100001011100110111100011001001000101110000000101100001000001011000001110000010000000000000000110001
