11101000000000000001000000000000110100010001001001000010110100000000100000010001011000000000000000001
10000010000000010001001001110100110100000000000011001110110010001100111010010101100001010000001010000
01000000000000100100010110100001000000100010011101000000000110000100010000000110000010000010011000101
10100100100010000101000100000011001000101010110101000100101000000100010000000011101000010010011010000
00000100000010100000001110011000000000011101110100000100001000010001100011001000100000110000010001011
00001011000100100001010010100010000010011011001000101100100001000011010000010001000001000010101000011
00000110110000010010000100010000000100101001100100000000000000111110000000000000101110000001000000100
10000001010101011001000101000010000110110000100000000101000000000000000101010110010000010010001000000
01001000001011100010000001000000010011101001010001010000000010100100000001000000000100000111100100000
01001001010010000100010100010000000100100100110000101001011010000000000001001101011001001101010000100
10000001101000001000010100010011000000010000100010010011000100111110000000110000000010110000100101100
01000100010000010000001111000000010101000000001001000010100000100001000100010000101001001001100001011
00000000011011010110001110000000100010000000101010000000000111011000110010000101101001000001100001000
01001000000000010001000100001000000101111000100001100001001000011000011000100000000000010011000001100
00100101110010011001000001001110100111010010001000100101110000000001000000011100000000000110000001000
01111010000010000000011000000001010000000011000101010010000100000100100110000101100000110100000111000
10110100011101000101001100101110101010010000000011001100000101000001100000000010110010000010000001110
00001000000100000110100000100000101000000011100110100000000000111010010100100000011101111000110011000
00100000100000000011000000000001011100000000000010000000111000001000100000010011000010010111100101100
10010001000000000000100010010000000000001010101101000000000011010000100110000000100000010011000000000
10101000111001100000110010001100101000110001001010000000110011110010010000001001000001010110001101000
00111000000001001001000001111001010110000001000101000010001000000000100000100000000011100100001010000
01010100001000011010001110001010010000000001010010110000000100000000100110110101000000110001110011000
00000000100001001000000011000111000011010110001100001000000000001000010001101101001100000001011010001
00101101000010110100001000101000111001101110110000001011010000100100001001001100000000010111111110000
01100000010111001000000000011000010000100101001001000100000001000000000001010010000001011001001010000
00110000000100000101011100111000100000000010010011001000001010011000000000011110110000011000001101010
10000000001100001001000010000011100000001110000000000100010000000001000000000100000011000000100100101
00001100000011010101110001000010101100000101100000000001000000000100000010000001110110000100010101000
10000000100100010000000000110110000011011000011101000010100110000000000110001010000000000000000110100
00110001000000000000000001010011000001000100001110110001101100000010001100001000000110000001000000000
01000100000000000001001000000100100000101011101000000000100000001011001110000010011000100100000001100
11001011010011000011100010000101000011001000000111000100000000000000000000111000100110000100001101000
00000000000100000111001011101110001100110000000000000010000000000001011100010110000110000000100101000
00010000001101000001010010000000011110001001100010000011000100101100100101000000111001101101000111010
10110111110110001000010001111010011100101000100101010110010001101100010010000001111100001110010100000
01100000010000100001110001110100001011010011010000000111111000000110010100000000000000100000011000100
11100000000110100000000000011100000100100000001000000111100000010010000100101000110000000011011100100
00000000000000100001001001000001010100100011001000010010000010010110000001101101100000010000000100011
00111000000100010111001010000000100101000000011000101010010000000010000000100100000000000000110000110
00011001000101001000100010101100011110000001100110000000001000101101000100101100010101011000010000100
00011110011011010111011000101000000010000100001010111000011101000001001111000001000010110001000100011
01100001111100000010011001100001101010001101100001000100000000100001000100010010000110000010010000000
01010000000001100000000000000011101000110001101101000010011010010000001000000000000000001100000111000
00000000101000000011001010100110010001100000000000100101001000010010010001110100000000001100110000001
01000001100100100001100111010011100001000000000100100010000000000111110001000000100011000000000101001
01010000010000000011000100000000110111110000110000001000010001000000001010100011010000001101100000100
00100000100010001010010101000000011000010000010000001000010000101100000100100010001101011000000010011
00000101000101100001000000100100000100011001000011000000101001110100010111111000010100111011100001000
00111010000000001010101010000000001010000100010101100100000000001101010000000010100100011100000100100
00111000011001100011110101010110100100000001110010011001000100110110000010110101000000000010010000100
10000010010000101000100000110100101010001100010000101001001000100001001100111110010110010000001101000
00000000101000001001111011100100001100100100001001100010011001000000100010011000000010010000010011000
01000110001110000100000000010100001010001100000000001100000110100001111101100010000000010011000010001
00100000000000001000010000000000000001100000100001011101101100101100000000001001111100101010101010010
00011010000010000001110000011110010011100010010010000000100101000000000000100001011110001100110000011
00001100111001101010001000001000000111001000100000011000101101101000010000001110010000010000010100000
11000000000010000010010101000000010001001001001011110011000000001100000111000100011000000100100000000
00001001111011010111001000100100101001100101000000100010001000011000001100000100001001000001010011111
00000000000000000000010000010000011000010000010100000001100010000100000000010001000100000000000010000
01000110010000000100000001101011100110100110011000100000000000100000100000101110000000010000010100101
00001000100001100100100011100000100000000100000000110000000000000000010001010001000000100000010000001
00100010011001100000001010011001000010001000000101001010100110000001000000101110000000000000000000001
10100000010000010000000010001000101000001100100000111100000001000101100100100100000000010100000110000
00001010010000000001010010000000010000110000010001000100000000000010000010100110111000101010100000001
00000011001001010010010010000010100100000000001001000010011001100000000000000001100101010010001000010
00000001000000100110001101000110000101000001000010001010001001010000101000110111110000010100000111000
00000100100011011000001100110000000000001001100000000000010000100000001011000100001001011100000110000
00010001000000010010100000000000100000011000000001010011000000001000100110000000110110100011000001100
00001100010100000001010000110100111100100001100101010000010010000000000000110100001000101000011001001
10100111101110000001101000100000001010000010000001101010100001011110001100000011011110010000000101000
00111000100000100110111110000100001110010001001000100100000101000000000111010100010001000000000101000
00000110010011001111000000010001101000010001110100000001000101000000010000001001010101010000100110100
00010010110000010000000010101000000101010000000100000000011000010010000011010000110011010110000110010
00010000001000000100111100110100100001010111011000111010000000010010000001100100000010100001000000011
00000100001101100000001100001000001000000000001100000000001011000100010010000100011100000101101110000
01010010100000001000111000000000001001001000011010011011100000000000001000000001100000010111100100010
10000000010100000100010000000010010100101101100100011010011000001110010101010011011001000001010101010
00111101100101000001001000100000000111000100001110010000110100000100100000000011000010100100100010100
00101001000110110010001001001000001101010000010010000000000001000000000011001000110100100110000111100
10100000000011001000000000110011100000100000011000010111000010100000000010000000001000000010001100000
01000001110000011001000001000100001011010100001000000001000100000001000111011000000110110000000001000
00100000010000100000100000011010010000000010000000000110110001000001101011000001001001000100010000010
01010000010010100010100101000100010010100011100100010000100100001000110010010111010110000010100010001
11000000000000000000001101101100001000000000101110100000110000000000001000001000010100001000001010000
00010011100011000000010010001000000000001011000110100110000010100000100010000001000100100001101101000
01101011000011000001111110100000000000000101000000000000100000001010110000010010100000111110110100000
11100010010101000001010000000001000101100110100000001000000000000001001111000001101000100010011110110
00011110001010000000000101010000101010100101100000100000110110001010100100001111101100100001000001000
00000000100000010000000010000110110100001010000000100100000101001001001001000011100000101001001000000
00000000110011100010111110000000110010110011110000000000000100101010100001011110000000110000001010010
01000101000001010110101000001100010000001111000000001100101000110000011011011000100100111101000100001
10000001100011101100000000010000100000000111011000001000000101010001101000001101100001001010100000000
00000100010000001000100100000001100100101110101110001000100001000000111111011111001011011000001000001
10000101001011110000100000011000010010001001000101100011100101110010101111101011010000101000000000001
11000010110001100000000000011100101000111100001000000100001011000000110100100000000001100101000110000
00100000001001000000001000110100010010101000001000110000010010001000100000010101010110000001001101000
00111111010010010010010010100010010000001110001000101010000100110001001110110001010010000000000111000
01000110010010000011100010000001011000100101001001011001000000001000000101100001010100100010001000010
00010101100000001101001000000000000110000011110000010010001100100100100100010111010000000010011100010
11000101111100010010011010100000000110110101010100000100000110100111001010000001110010010001000010010
