10010000000101000000100000001011100100010000001000100001000010000011000100100111001000110100100001001
10100100110111011000111010111001000010010111000101000100000000010000000000001011001000100110000100001
10101110000001000100100010010011010000101010011100110000010000100000100001000001001000011000001000100
00001100100010111101001101000100010000011110000010001010100100010100101010111100010010100100010000100
01001000100000000001000111010010011011000010000011100000000011010001011010110100010011000100001000111
00011001001100101111011110100001000000000000100000000110000100100010000001101000100001100100000101110
11000010001001111001000010000100000100000000111101000100001000000100001000101000000011000000001000000
00011101001010000000010001100000000101000100000100100101000000100010011100001000000001110000100101000
00111000010000001010010000010000101001000110000010000010100001111111100011101000000100101100100110100
00100011000010101000010110010000010001101000011110010001100000000001100001100100001010000000001100011
00101110000000000100000011010000001001010000100100000110011011000110000001100000100000000100000110000
01010011100001000101001001001100100000001000001011100000100000110010000110010000000101100000110010000
11000000010101100000100010000001001000010010000110101101100001100001111110000110000000011000011001001
11101000000000110100000100111001000010100000100110001110000001110101001011110001000100001010000000000
10011001011111100001000011000100000001000011100000100000100101100100000001000000000010000000100000001
00010001100000011011100010001000011000110100011111110011000100100001000011010000000010001000100010000
00100000001001100010100010000010100000000011111000011000010010100000010010111000000000000000100000100
01100000000010001100001001101011000101000100000001100010100000000000100000010010110001011000100010101
01110100001010111000000000000001001001111000000101001100100000110110000110001000011001000101001001000
00000000100000000000100110011010101000000100010100000000000000010101101010000100100001001000100000101
11011100001000010100010000001110001000101000100000100000010000010000001000100001000000001111110000110
00000100001010100000001001000010100010110011110100000000110001100001011010000100010010101010000001000
00100010001010010100000001000000110010100100000111000101110010000100010010001000010100000111000110000
00001010000010110101001010000000101100010001000010000100000001001000000000100010110010010001000000000
01001000000110000001000011000101001011001001001010001100011000001010001111001101100000011011110000011
11001010100000000001100000000110000000101001100001000100100001001000000010000000101000001100000000011
00000001001011001011100000101010001101100100010101001011000000010010111100110010000100000100000011000
00111000100010001000010001010000000011001010001000000001001110100011001101001011100001101001001001011
00001000000000000000100010100000100100001001000001000011100100000111010010011100001000000100100000100
00000000100101100100101010010100010000000110000101001010010100000100010000011010010110001011011001000
00000001111100000000010000000001010111010100000001000011001000000001000100000010100010010100000111010
01101111110000000100000000000000100010101001101100000000000110001111000000000000010011101010001110000
01000001000010010000000000010100100001000001001000000000001000110011000101101000011100001010101100000
01000010010000000001000000100001110010011110001101000001011110010000000000000011001001110010000011010
00000001010010100000000001110010100100001001100000010110110010100000101110000100001100010100001011000
01100000000101001010000000010100010101100001011000011010000110000101110000000000101100100000000001000
10000000000001001001000011000100111100100110010001100000111110110000001000000010000000000000110100001
00000000010011000110001100001000000000001000101001010001000000100000001110000101000001010011010101011
01100000000100001011101010000111010011100101001000000000000100000010010011100101000001000100101001001
00101110000000010100001011000010010000100010000001110010111110101000100000001000100100100100100000000
00100000011010000001000111110000000000000100011101001000100001100000101001100000000000100001100101011
00000011001100000000100001011001001000000010111100000010000000000110000000010000000000000000001011000
01000000100000101000100110100010001000000000100101001010001000001000000001010000000000000010011100001
10000000000000000001000001000000110100101110010001001101000000000000000001010110001010010110000010010
00011000001011101000000100001010000010000110001111101000110100111001000010001001011000000001000010010
10100110011000011000010100000111100001000100000110010100000010011101001001000110100100000001110000001
11100011010000000100010100010000100001100011101110110101110000011000100100010101000000100011000100001
01100000011100010000100011010011010000000000011000110100010110100101001000110000101001011000000010100
01111000010001000100000000001000100110000001010100101010000000011110001110100110000011100111000000101
01100001010000000101010000011010000100000000000101111011000001001001011000111010000100110100101010010
10000011011001000001100100011000000001111100000000101010000000011100000100011000000100001010010001100
00100010000000001100110101000001010100001000001000100101100111010010101110101010100000000010110100101
00100010101101010100000000011111101000010000010000000000110001000100001011001001110001000000000001010
10000000011000100001010000000011000010000000000010000101000001001000100100000000000001000000000000001
00101111010100000110100000000100000000001100000101010010001001111110100000101000010000101100001100000
10000100000100011000101001011000000110000110100100100000101010000000010010000010000000001110001101110
00100110100111010010010110110000101010110111101010000000100010000000001001100001011001001000010110010
00001010010001100000000001100000001011100110000011100101001100101000001000000000001011001000011101100
10010000000000101000100011100100100010100101000000111110001011001110000000001000100101001100011000000
01001001010110001100010101011000000001001101000000010010100011010110010111001000110010000001111100000
00010000001010100000110010000000000001110100100000101000000001010010100001000000001101010010010000100
00000010110000010110010111111010110010000101000000000000000100100000010010100101101010111001101000100
00101000001100010000110110000110110000000001010010100110000000011001100001000000000001100000000000000
00011111000001000111010010110100100000000001000101110100100100000101100100000101001100001001000000010
10010111001110001010010000000000101110110001010110100001001000111010000000000010100000000000010010000
00100101010001000000011011001000101000001011010110000000010001010000011110001111010000010100000000101
00001000100100100100010010111110001000000000000001101100001010100100001000000001001000000010000011100
00011000001110100000000010001010100100000110001100010000001010111000000001010001100001000001000000100
00101000100000101010000000111000100001000000101010011001100001110100110010101100000000000001110110110
00000000110000001001000001010100001100010000010101001101011000100100010000010000100000001000000000010
00000000011000000010001001110010100010010000000100110000001110000110000000000000000010010000100011110
00111000010000100100011101000100100101001010000100000011111100100001100010100010111010000000011001100
01111011001000000001100000000011110000110000010010010100000000000000010110100000010000010001010111110
00011001000000011101000100010101000110000010011101000000110010010000010001010010001100110000000000101
01010100100010001100011001000000001000001010100000101001110100100001001100001000100100010100110011101
00100011010010001010111100010010000010000101100101100101010010000000100000000101000011000101000000110
10000000011100001100010101011110100100010000000000000010010100101000000000111110011010001000101110000
10000100000100010000000000010111000000011000010010100101100000100010010001000000000110000100000001001
00001110001000010101101001111000000100110010011001101010100000011111001000011010000000000010011000110
10100010001000101110010010101010010000110000001000100110111000000000000000000000000000000000000011001
00000100010100000011000000010110011100010011000000000111100000000000110001000000001010001010100100010
00100000000110000000010000100001110110100010101100101010100011000100001000001001111000011011100101110
10010001010000101000100100100100000001101000010100001000000001110100000111100100100000011100000010010
00000000000110001100011000011000000110000000000001001100010001100100010010100001010000111000100100010
00000011001010000110001100111100101100011010000010011010000000010001000000000000001001100000010000101
10010001000010010000000010000100010011010010000010000001100011000100001101000001000100001101000101000
01010111011110100010000000000100000000100000100000010101100000000010011101000010010001001100011011011
10100011000010000000000000100101001001100000011000010001010100010110000101110000000000110000110100000
11110000110111000010100001000010100000000010000010000001000010111100000111110011000010001001011000000
00011000010001010010001010100010010010100001100000000101001111000100000001111110000000010000000001000
00000010001010011010100110011100001001001000001110000000001010101001000100001100101000010010000000000
00110000011000100100000000110001000111111100000010001010001001000000000000001110010100100000000011100
00000100000000000100001110000100000000011000110000110000111001000100000111001000111111101110100000010
00010101000000011000000000000010000000011010000000000000011000000001101001001010010011100010010100010
10000100001111111000000001001100000010000000000000001100100010100000010000110010001100001100011100100
00001001110001001100010011011000000100111001001001001001000000000011001100000001010101101000010000100
01000001000010101001000001010010110001000010100000000001011000100001101100000110011010010000101011001
00100011001111100000111110000000010000001011010001000000000010100000011110000001000000010001010000100
10110000000000110111011000101100001001001010000010100001101011001111000100000010001110010001111001100
10000011000101101010101100010101011010100000111110010000101000000001000000101101101110001010001011000
10000110001000000100000110101010010011010000000001010010110000000000010000000010000100001101001100101
