00110011000110000100000010011101100100111010010011011101100000110111000100010010100010010100011000010
10100001000110100001110000011000100001100000000000000110000001000110101000001010000100100011010011000
00000100100000100100000010001100100010010001001100100011001111001000000100100100100110000110000011000
00000010010010101000101000110101010010100000100000000000010000100011001000000000001000110001000010100
00000000111010001101100110100110101000000001111000011010001000101010010010010000010100100000010001000
00100110000000100111100000100100000011111000101001010001010010001001010001010101101000000000010110000
00000100010010001010000011000110010100100000101100100000000000100000010001101100000000001101010100100
10010010000001100000000111011101001011010000001110000100101011000110010010101000010100010100010100000
01000001010001001000110010000000000000101100000000000101001100000000010000001110000100111000101010000
00000000010010101110000000000100000001110010010011011000101000000000010000001011000001000010000000000
01100000000000011110100101000110011001000100010000101000000110100010101001000010101010000111001001000
10000010010010000100110111000000100001000001010010001000000000000010000010001010001000100100000101000
00011000000001000001010001000010010011011111010010000110100000101001100000010100101101110010010001111
01001110110000000000011000000000100000001000010100100000001110100000000010010010000010100111110011001
00011010000100100000000000010000000001000100001100001100010000000000100110000001000010010000001100000
10100111000000101000011000011001000000101100100010000100000000000000100010000000100000001000110110000
10010111000011101010110000100101101100100001100000011110010110100011000000000010000010001000001000000
00101100000001100101101100001010000000010001010010001111000011001010000000100010001100100000010000000
00000010100011000001110100100100000010100100011101001100000001001011001101000101001110100001011010000
01010100111110011000100101100100110000100000010000000000101000101011111001011000000010011010000100100
00100000001010101000010000111011100100001111111010000000001100001001001000000010001000000100101010000
00010000000000100100110001100001111000100000100000110000000010110010000010011000010110100000000000000
00011000010000100010000010000011001000001000000100000001000100100000000010100000000000010100010000001
11000110000000100010000010010000000010001101111111011000100110011000100000001000000110001000101010101
10011001000100001010100100010110001011001011000011011011101100000100010000000110011000010001010010100
00010000100010000011110000000010100100100010000001011100010010101000000000011000101001000010000011010
00111100000000000000011100000100000010001000001000011000000011000011100100000010010001000000010000000
01000000010100110000001010000110100110010100100000001100101010011010000000000010000000001000000010010
00010010110110111001001000000000000000000000100000000001111000010011000000100101001010001111000010000
10010011010000010101100110000001100110000000000000000000001100001110010110110000000001001110101000000
00000001001011110101101001101010010010000001110010001000010001100101110000100100001000000000110100011
01110000000001000100000101001000010000010001100001010010000000001110010000000000001110001001010000100
10100010010010000100000100101001001001001111000000000010100010000001000001001010000100010110000110000
01000100100010000000000000000001000011010010000100011001000100011110101011000101010001100111010100010
10000000010010000111000000000101000000010000010001000110010010010001000000001010000001100010000000010
01101000001001101000000100000101011010000000010000000000101000000010100100110100000010010101000001000
10011001000110100100010000110001001000110011011000010001010000001101010101000001000110000001100000100
00100000001000001000100000000001100011000001001000110000100011001101010010001111100001011100010010100
00100101000101000010010001010000000010011001110100001100110000000100000000101000001000010000000000000
01100110000000000010010100110000001000100011100101011000000000011010111000000110011100101101001000001
00000010000000010000000000010000010001010011100100001010100001001101000000000000000100000000000000100
00101000001010011001000001001011010011011000000011000000011101010011000000000001000000110100000000100
00101101110000001000100100100000000000001011111100000000000001011110001000010000000001000000000100000
00010000000000001101000001000010101000100000010000000000000000001000011010011100001010010010000100001
00010101010010001011000010101111000010010000001001110011010000000101100000001110000100011100000100000
00001110001000110100011000001100001100000000000110001000000000100000101100010010101110100000010010000
00000110101100100000010000000010001010010100000100000101001000011010010100000010100000001000000100001
00100101010000010000010001001111000000011000100000100000100011100000000001001001010000110100010000000
00100100101000101010000010010110000010000110011000000101000110001000100001000000111100010010001001000
00010000000001000000001001100101001101100001000011100000001011010001100100000101010010100000000000101
00110000010000010000000000000001100001010000000000000101011010101100010000000010100100010010001000001
00100000001010000100010010100100100001001110001101110001110110111000001000110000100010100010000111000
10001010101010110000000001110000001100000101000000110010011001010101101000010110001010001001001000001
00101000100001000000100100010100100110010000100001001010001000001000001000010001000000000000000010110
00101100010000011001010110010011010100000000000010000110100000000100011100010000000001101011000000110
00011000001010000000000000110011000101100000000010000001100010101000000010010001010000100000100100000
01000001001011100011100001101000000100001001101010100000000100000010000011000111000101010100000000010
01000001010000000100100000010001101000000011101001100100000101100001000100000000110000010000010000100
00001011100000100101010010010001010100100010010001000010001000001000000000001000010001001100010011010
00000001000110001101011000010001000011101100000101000000110001000100000010010001100000110000010010000
00110000011001001101000010100111000000001001110000110000110010011000000010001000001000001111110010010
01101000100010000000001000001001000010010000000000010000111000001110100101101001101101000000100010010
10100100110110010000000010101010000000000000000010000000010100000100000000111111010000000011100000100
01010111100010100011000101010000010000101000100000110000000100000000110010100011000011011110000000110
10000100100000000011000001010000011100101010010010011000101000001100000010000000010100100011000100001
10001100000000010000001010001010000000100010010100011110100001000001000000000100000000000111000000001
10000011001110000000010111000000011000000000001001000000000000000000000011100001000010010000000000000
10100000001110011000000010001000100110010101000000011000000001000010000000000010001010001100110000010
00011000000111100110001100010100000000001100000000000000001000001000000000000001000000000101001001000
10000001000010001001111000011101010000110100010011010000100001010001000000101000001010011000010000100
00110010011010101000000001000100000000111000111100101000000001000001111001000000011100000101001000101
00000010000001110110100000001100100100110001000000000000000000010000010001100001000000001000110000011
00001000010000100010010000100010010010001000000010000010100100001000000010010001101001000101000011001
10100000000001000001001111000100101011100001000110000010010000010000110100010100001010110101100001010
11010000001100100010100111000101100000011000000010010000110000000101001111010110011011101100010000101
10001000011000000010101001011000101111010000000001000000111100010010010001001110100100000111100001101
00000000000100001110001001100110101000001000100001011100000010001000100000000000010000101000001000000
00000111011110000110110000000110001001101000101000001000000000001010001000100011100010010000000001110
01000000110000100011101010010100001100100101000000011110011000000010000010101000101000010100000010011
00000000000000000100000101010100000011000001011110100001101000000000000000000001010011100111000101000
00010101100000101011000100100000000011001111000010100000100000000000010010001000010001110000001000000
00010000010011100000010010100010100000110000011010000010000000001010100000010001011001010101000011011
01101100000101101111000000100000110011010000001000001001010001000001101001000011000000010000001000010
00100001000010011110000100001100100011100000110001100111100001000001010111100000101000100000000110001
00100010100101011000110000001110110010100011000000010001001000000100000010000010000010001101100110000
00000011000110011100000110000100010011110001001100000000000000000000110001100110001010100101010000010
01000000000100000000000100100000000101001010000010001000011110101011101110010000000000001001001010000
00101100100000001100000010100011110001001010000000100001000001000001001000100100100100001101010000000
01110111110010001000000010011000100100100001101000110001000101011101010000000000000000011011001100100
00001100011000010100011000011000000000100001010001000100000011101010000000000000000010000010010000100
00100010011001100000000110100001000111010101001001100001100001011111000000101000000011011010110011000
10100010100001100101000010000100010000001001010100000000010101000110000000000010000000000100000001011
00000000011001110000000010010100100011000110101001000000100000000000010001001101010100011101000001010
01100001101001000001010011000001010100100110100000100100110111100001010000100010000001011100110111010
00000000000010010000100011010010010101000000000000100000111010100010100100000010000000000010000100100
00100001010000010001101000100001100000101101000001010101110000001010000110000100001111101001101111010
00001000000100000000110000100011010100000111011100100000000100001011111000000100000010011010001001100
10011010110010100001000000100000110000011001100010100001100100000100000000000010000001110001001001000
00001010010000001000000010010110100100000000001010010000100100100001001010100001100100000000000100100
00110010110100110101001010001010010100010000000000010001001001000010000001101000000001100011000000010
00000011011100010110000000001010110001001101101110101000010011100000010100000010100100100010101000000
