01000000000101010111010111011000001000010000000001100100010010010100000000000000000000011010001000010
00101000000001000110000011111001110101100010110110010001101000000010000100000010010010110101110010000
00000000100101100001001000110000010010000110100000111000011001001000000011100000000000000000111000111
10001011010100111011100000100001000000001100010001001000010000001000110100010100000100010111111100100
10010100100000000010011000000100000110111011101110000010000011100000010010000000000100100100000100001
00001001000011110000011001010011100001011000100010100110000000000000000000000010100000001000001000000
10100010001010011000010100011010011010001000100000000100000001010001000100100011110001000110011110010
11110101000000000100010000110000100001101000000000000110100100100111011000011010010010011010100001110
10001001000110110000000000001001000000000110000100001000011001001101000000101100100100000001100100000
01110001000100000000000000000011000100001000000001111000110100011010110000101001000000000100001000110
00001110100000011101010000000001010010001000000010000000010011100010000000001001100100001111100100111
00100010110100010100000100011000000000001001100001010010010011000000010100000010000000010000001001100
00100000101000000011001101000110101001001011010000100100000001000000101100010000100110000000001001000
00000000000000000000111000101000001100100000111010001001110101100110000101010000000000000000000001000
01100000001000010000001100000000100001000101001001000001010011110100011000010000000001001100101010110
00010001010001000010000011010110000100001001000010000101101001110000000110100000001100100000010000000
10000000000000010011001001010110101000000100000010000000100001000001110010000100001100100010011010011
00100000001100101001000000100000000010000001001101011000100100010001000000000010000000100000001110000
00010011100101101010001010000000101010000000000101010011000011011010100011000010001000110000100100100
10000101000010001000000111000000000001011000001000001011000000010010000001100000100000001001001000010
10001000001010000001011100000100000001010101000100000000100011111100110110101100000000100010000001100
10100100011110101001000000100000010000000010010011100000000100100010011000001101001011111010000000000
11101000000011000000100000000011110000000000000000000000000000000000100100000010000000000000000001000
10010000010010011111100010110100000111100000100100100001001011001000001000000000010010100010010001000
01100110100000100101000100010000010100000010000000010100111000100010110000000110110000000000001000000
10000000111011110010100001010000100000011010010000000001011100000000000010000000111001100010100011000
00010111001000000110000010001010000101001100000000101010000000100100000011000010100001010100100110011
01000000110000011000000000100110001101100000100000000101000100000100010000000110100000010000000010101
10001100000000100100000010100000101000011100111000000000000110000000000010110100000001110110101010010
11001100010010110010000101000001100101100110010000000000010001000000011101100110111010000101101100000
11000001000100100010000111001010000000010101100000001000110001011000000110000000000000000001111100011
10100001001100001000010000001000011010000100111000100111011100100100000000001001011000101000100001001
00000100011100000100010110000010110101000000010011101000000011000001000000010011010101001010011101100
00000000010100100011000000000000100100101011000001000100010010010010001010001001100111000010001000000
10100000011001000100000100000000000000000010100010111001100000110000000111111100101010011010001000011
00000110100000100000100000100111000100010000001010110101011100101011111100000000001110101110100111010
00011110000010010010001000010001101000100100110011000111011100000110011010000001000101000100000101010
01011000111100001001000001101001010001001000111011100111001000100000010011000000010100011101000000100
00000001000000001010010010011000001000000111011000000000000010100010100000000001001000010010000000000
00000000000001000010101101011101011001000000011000100000000101000000001001001000000000001000000100000
00101000000010000000001000001010100010001000001000010010100000100100001110000001000111000110000011000
00010000110000001011000100100000101111110000000001100001000110010100000001100000001001110110100100000
00001100010100001000101000110010000000011000000000110000000000000000011001001100100101110100000001010
11001010111010000101001000000100000000010000111100100000100000000100001000100000000000000011000100001
10000001010100000100000001101010001100101111000001010001000010111000010010000110100011001000000100101
11100010000000101000100000110011100010010100001001000010100100001100011101000000010000101100000100001
00011010010101010000011001010001001000001100001100000111111000101110100010000011000101101011110100010
00100010001011100001101101000100011100000000100000111000010000000011000010010100110011001100010000110
10000000100010110100001100101010000010011100100101111000101001110011000000001000010010110010100000000
00000001001010001001010000010000010000110101100100000000011000000001000001010001100010010000010000000
00010000000000000100000010101000000010001111000001100110101000000100100110101011001000100001001000101
00000000001001000100000100010101000010000000000001000011000001000000100110101010000000001000000100001
00011000000100000000010001100100110100000000000000101101000000000001110000101101110100001000100000001
01010000101001010011110000001110101001000000000000100000110000000100000010000000000000011111100001011
10100011000000000100001010110001100011000011000000100010101101010100000010100101010100000000010110010
00000010000000000000000000000000010100000000100000001001010010010110010101010010010001001011100000110
00100000000001100011000011001010000000001100110100100000110010100000001101010100001101000101010011000
01000011001000001011011000100000100000000000000110100100010000000000000010011000011000010100101000001
00000000000000000000011000000000010011000001100100010000100000000000000100101001010100000001011000100
01010000100001100011000001000010110000100000100001100000100000011000000011111111000001100010000110111
00000001000101001010000101100101000010000000101001010110001010011100001000010101000000010000000000000
00001000001001000000010110000000010001011010000010000110000000101100110011110010010010000010111100001
10101000101000100111001010100101010100100100001100010000000100000001000101010111010000100000000100000
10000000100010001001010000001101100100101100001000100000100010000000101010110000100100110000101000100
11010000000001000001000000000000000001010100000100101101101110100100010101001101010100000100101100001
00000010011000000101110000000000001110000000000110110101111000000001000111000010101000010011001001000
11000100001011000000001100100000010110001010100100000100001000111000000000000010100100000000000101010
01111000000001100000010010101101000000101001000001000000100010100010000110110100110000100010010100111
10001001010000110000010010000001101001001000100000110001011010001010110001100111110010000010000000101
00000000000101001001110100000000110010001001010000000000000100000111010100010000000001001100000101000
00100000011000001000000100100000001011000001100010010001001110010010110110100001100001110010000001000
01000010010111011000011011100000111001000000100000001001010100000010000101001100101000000100001010000
01100010100000010000001001010101010001101000010110101010010000100010100000000110000100000000001000100
00100000101000100000000000000001100001000000000011000100001000000100100001111000000100000000001000001
10100001100001100000000110100010000000101000101000010001001000000001101100100001000010001011000001000
10001000110100011010010000000101000010000101000000101000000001010000000001000010000100010101010010100
00000001000001010000010000000001000000000010101000100100001000100000000101000010010101100000010101000
00000010000000001010110101010000000000100011000001000000011000000001000001000000000011000110010001000
01001000010101110001010000001100100001110101101001000001001110000000100000010110100001100101000100000
10000101001000010010011000110000000001001000011000110000111101000010000010000101010010000000111000100
10101110010000110010100000001000000110001011000110011100001101111000000101010000010111111001010001101
10010010000000100111111000100000100100011000101000000011110000100000100010100000000001001010001000111
11101010000111010010000000000000001001100001000001000010100000000001011100010101001001000100000101000
00000100101101000000010001000011001101100100111010011011011000011000011000010101001000001001000011001
01010000010000110000000110000000000010010001000001010110010010000000000000001010101000110101000001010
00000010000000000000010000100110101001100100011001000000100010000011101101111000010100000000000010000
00000110101000101010000000000010000100101001101110111010110100010001000110000000011100100000100100000
10000000001100000001000000001010110000000000001010001000100011001000100000010110000001000000010000000
00000000001100100001100000000100000100000011000110001000110100010100010001000101100000001001011000000
00111000100000001110100000001000000110001001000100010000011111000011001101001001001000000001010000000
10000000001100010000001100001110100000001000000001010110111110111000000000010010100100010010001000100
10100101000010001101000000001100110000100010010010000110010100000010010100001011000001011110100001000
10000101010000000111000100010110110100001011000010000110100100000100110000010011000100000101010100111
11000101111000010110000000110111100000001000000011100000111101010010001010110010101110000110100110001
10001100010110001000100010000010010000001110100000010001100100010100000000010000000001100011000000100
10001010000001100000111010000000010011000001000110000100000001001010000000010000000100100000000000000
00111000010000100000001000010000001001110100001000000000010000101100111111000000000000001100001110101
01010001000110110000011100010000001010110100000000111010000000000100101001000010010100000001101000100
10010000001000001000000100000011100000010000010000000000001100100110000110101000010011010001100100100
01000100001001000010100000001000110110000110100000010110000100100001101000010010100001001010010001001
01101000000001000101000000000000000001111001000000111100110100101001000100000000100001110000010000100
