01001000010010111000100001000000110000100111100000000000010010000000101000101000100010100000010100011
00100100100000001001000011000000000101000101000000111000000100001000000101000001101100000011001000000
00001100000100001000100011000010000000001010100001100000001010010000010100101000001000011000001111001
11000000010011000011100101010001011000000000011011010000010001101001010000010110000001100001001000000
10011000001111101011110101000001000100010011110100110001100001000010001110001010100000010100000001100
01011010100000101000100001001110110010100011000101000010010100110000001000011101100000101100100100000
00010100100000000101000001001100010001001101010000001100100000010100000101100011010100000000010111000
00101111100100000010110111000000011010000100110011000010100000010011110100010000000000000000010010000
10000000001010100100000101000000000001110100010000000001101010000100000001100000000100001000000100001
00000000000010100010100000001010011000000000010100001011011110001110010000000000000011001000000001000
10001101010011110000101000000010101010000000010010110000000001011000000100010001011010000101000100110
00010110001000000000100000010011101000001011010010010010000010010011010000001010101100101000100100000
00010111001010010001001100000000000010011000101010010001100001100101000000111001000001101011000111100
00000101110110010010001001010010011010000000100000100011000000100100000000001101111101000010001000000
10010000101100000100001011000011000110000000001001000000000110111100100000000100001101110011000100100
11010010001100000000000101100000000100001000100000010010000001100000000000001110010000100100011000010
01000010000100111010010001010011100000100100000001110100100010001001001000110111001001000001100110000
00011010010011001011001001010001001000000000000010000000000111011000111100010100010000100001000011001
01100000111101001010001100100000000000010000010000000100100101000000000000100000000100000000011100000
00110100010001000110000000001000011110000000000000100100001000000000010011100011000101001010001000100
00010000000110010000100001100000000000000011101011000010001100010010000000000101000010001101000100010
11000001000000100011000001011000000000001010010011100100010000000001010000001100101101010100000101000
10100100101010100000010100110000011000001000100110010000000000001001000000100100010000110110000000011
10000010010000000010101000100010001000001001000010000001100000000011000010000100000100111111000010001
10011100000000000000001000100110110100000010001001000100010100010101110001000110000010001010000100000
00110110000000100010010000000001000010011100010100110010001010000100001000001001000000000011000111010
00100100110011000110001000000000000000011001100000000000011000010100000100110001001100100001100000100
10010010001000001010100010100110110010011001100001010010000011001000001000000001000100011001011011010
11000110101001011001000000000010000011100000000101001011010011000111010010010100001010010011001001010
01000100001110000101001010010011000000001000001000100001111000010111010110000000010000010100000101001
00010000011001101101000000111000010000110010110010100100011000000000011100100000100101001010011110000
00000000000011111001000000000000000001000101000010000001010001011000100010000000100011100000010000100
00001100001010111100000000000001110001000011010011101001000000100000000101001011101010011000100100000
00000010000010010001101000100010010010100100000110010001011100101000001000000010100100000000100010000
10101110000001000100100010000001000010000000010000000011000100001000000000110001000111110011011100100
00110110100001001000010001100011010000000010001000000010000010001011011000010000000000111000100010000
10000100110000001101001011000000100001010001110001000100000001000100101000000010101101001000000000110
00001001001010000000101000001000001100100010000000000100101000001101010010111100100010010000010001000
00011000010001100010000011110010001000001010000010100010000101000000000001111000001001000100000001000
01010010101001010000100011010010100001100100010000100001100000101010000000000110100110000000101000001
00010101010010000001100001000101010010101000011100000010001000100100001111101000000010011000011110000
00000100001001000001001001000110011100101110000010110110101110000110100001001100000001001000100001101
00000010001000101100001000001001000000100001101011011000100101010001110000000110000000000000110001001
11010101000000001000000000100001100010110001111010101100011000000000001110010010111011000000010001001
01001000000111000010010000000000010001001011001001000100001001101000000010001001100010000000100000001
10010000000111000100000000000010110000000100010110111000000001000101000001000001000000111100101000010
00100001000010000000011000000000111000000001000110000001010001010100010001100001100001000000010000010
00001000010010000100000001101101000010001100010000010000100000011000001000011000000001000000010101100
01001100001000110000001100010000000100000000000111000000010101111000110101100000100010110110000000001
00001110100010100000100010001011000010001100000000000011000111111001000000000001000001010000000000110
00000100101000000010000010101000100010000000110011000011001101100000100110001010001100000100100100101
01010100010100011010110010100000101000100000001010000011000100000000010000100001000010010000110000000
00101100000111101000010101010000110000100010100100000000000100010111010101000001100010000001001011100
11100000111000000000101101000001100000000100010000011001100011000010000110010000000000010100000011000
10110010001100100000000100010111110000110000110000011010000000000100000100100101000111000001100100001
00000000111010001000100001000000001001000000101010000101001010100100001100000001010001100001100110100
00010000001010010110011000001001100110001100100001000010000110100101010100001100011110000101010110001
10100010000100000110010110011111000000100100100101000000000000011010010101111000100000001100100100001
00110000100010010100010000010111000101000011010100000100001001000100000001100010011001010010001011000
00000000011000110000000001010100000010001010000001011000000100000010010100000110001000101111111100000
11000000010000001010000010010010101000010010110001010101100000001001000100111101100111100010010100000
01010110000000000010000010000100000100111011000101010100000010100100100110010000001100001100010000001
00100000100000100000000000010100010000000000000010100000110010100010101000101110000011010101100010011
00100000000011111100000000001000100010001000101000000111000000000000010101011010100000101000001010000
10101011100000010010010010101000000100111100000000010000000101001000010000100101100000000101001110000
00000001000111100100000010000110000110010001110100001110110110010000000101100000000010101100000100111
11110010110010001000100010101100000010010011010000000000000000111101010010000110000000101001100110100
00100000100100001010100101110001000010010000100010000100010111001000000000001100010000000010000001001
00000001100010001101000010110101100010000000010001001000110100000100001010110000001100110101000000000
00000110000010001000000101011100000000000010100000010100110000000010100000000000000010000111000001010
10110000000101100000111000010010000100011000000100010110010000100101100001001101110011000100000010000
00011010100000000010000000000000000101101111000000000000000000011000001010000001010100111000000001001
01101000000100101011001101010001010100000000000000010010001010000100000001011110010000010111000010010
01000101111010100000111000010001000001111000000001001111000110001111010011000000101000010100001000111
10110001110000001011101001010010100000010000101100100100000000001000001110100100000010000101000000011
00101100000010000001101101010001000110100000000010101000001001110100000100010001011110000111100100001
00001001000000100010100000100000100010100010100001000000011101011011100110011111010100010000010100000
10010100011001001001010001011000010000000001000100000100101000100101100100011001010010000010011101101
10101010000110010111111100101011110111010010000000000101000000101111001001001000010010001000000000000
00100001111000010010100100100000000001000110101000100110100100010100100110001010000001110101000000001
01010110100110000010000000110000001010010000000100000010001100011000010000110000000001011000100000100
11000000000000000100001001001000011011000001000100000000000100000100001111000100110000000001000111100
00001000100000100010000100010001110011000000100101000000010010000001000000000100110001100110000001110
00000010011010011000000010100000000000100110100101000000000101000111001000001000100000001010000000000
01001101100001000000011011000001110000000101010000010000000011010100100000010010100000000100000000111
00000111000000010001100000110010001001110000101101010000000011011000100010100111000001000000001100011
00001100000001010000000000000000001001011010010000000000101000101001000010111001000010011101110110000
00110001010010100100001010100000000100101000100000011111000100001000000100001001001001000000011000000
01110111100100000000000110000000100001000101101011100010100001000000001000101010010000000010000010000
01000010100011001011001000001100101100000000000001000000010110001000100000111000010100101001000100010
11001011000000000100000001001100000000100000010010010011011100000000001010010110000001000000001000001
00000100001011001010001000011100000100000010001010101000101010110101000000101011000000100101000010000
00001000010100000001100000100000001010000000000000001001000100001111111000000010000110000101101000010
00010000010000000000010000101001000000000010000001110000000001010100001111001001001110001000000000001
10100011000100101000010010010111010000000110000011100101010000000000000100001101010010000001011010100
11010000100100110000110001000010010010110000010000001010111101010001010000100001010010000100111000001
00000001010001000010010001100100011001001000000000001000001000100100100000010101010000000011000001100
00001000001000101001000010000000010000000000100000000010010001111000101101110110000010100010010000001
01000111001010001000001000001100000101011100000100000110100000010000010000100001001001001100100111111
10010000010010010000000000101000000101001100101010100000001100111100101010100101100011100001000010000
11000001100000100101011000000000000000000110101000001100001010000111001001010000100000001000001100010
