01010011000000000001000001000010000001010010010011000100000010001100000100011110100001100000000000010
10000001101101000001000000011001001100010001000111010100100001011001000001000000010101001001011000000
00000000110000000011100101100010100010000001001001100000000111100100010000000010000000000000001100110
00001001101000001101000011000010000100010000100001000010000000001000001001000010101001000010000000100
00000010000000010010001011100010000000000100010111100001110111001110000010000111010011011010000110001
00001001110000001100010100010110110011010000111010000000100001000011001100001011100101100000000001011
00101000101000000011100100000100000100111010000101011010100000101000001001011000101010000000001010010
10000000010000110001101000000011000000000010001110010001100101000100000110000001010001010001110000000
00000001000011011110100000010100010001000010010101110010001001100010001100000010100100011010011000110
00001100000000000001000000100100101000010000011001101010001111100011010100010110000100000000101001000
11001010000000010010100100101000100010100001010000100100100001011010000000101010001100000111010010100
00011001110100011000000001000100100000011000000000100110010100000101000011000000010100000001000100100
00010000000010100000010100001000001000000010000101000000000010000001000000001100000010101100010011000
00001000110010000000000000100000101010010010001101000000100011000000010010000000101010001000011110011
00011000000000000100000111110101000001110000000000010000011110001000001110000000011101011000000000000
01100000111101010001011101000000000101100100000000000110100010001000000010000000100010010000100000001
01000000011000011110100100000001110101100000100100000000100000101000100001001001011001100010000010000
00001100010010100100111010000000001001000100101001011110001100000110000010000110100000001011010000011
01010110101100100001000001001100001000100000011001000000001010110001000001000000001100010000000110000
00000010000000101000000000100100000010000000000100000000000111011001010010001001001000000000000110100
00000010001010010100010001000001011000010000100100000110010001100010000001010101100100001000010010100
10010000100101101110000000110000000000001100110000010000100001100100000001010001001010000000000000000
00001101001100000010010101010110010011011101001000100010010000100000100000000000110100110011101000001
10000000001000011001100011000000111000111100100110110000001011101100000001110000101000110001001000001
10100101100001000100000100001110100000000000101001000001000001000000000000010001111101101101010100100
01101000101101000110000010001111010000000011000000110000101110111011000010100000000000000000001001000
00110011010100110000011001111010101101000000010110101000001100001100000000010001001000110000110001100
01101000000001001100011000000000100101110000100010101000010010001001100010011000100101110100000101100
01000101001001000000000000100000100100000110000011001001100110000000100000001000100100000000011001001
00010001001010000000010110010001010111000111000001001110001100011100001010010000000011000011100000101
00001100000000000011100010001000110111110000100100000000000001101001000000000000010001000000000110000
00001101110000000000110100000010101100010000001100010001000101010001011000110101001000010011000010110
00110000001000000000100010000000000101010110100100000100000110000100111000000000110011000000100100000
00110000001011110000010000010010010011100110100110000000011000010100001000001100111100000001010000000
10000000000000000001001000001000001000001000010010001100100100011001010000000000000001010000101100010
00101111001000000000000010100010010000001100101000000000001000001001010010010001001101010000001000100
00100000001001011100000001010000100000100000010101100010000101011011101010100010011111110001001000000
01100111000001000101000000010000001000001111000100110010001010010001111110111100010000010100100010101
00000000000011010101110011110101010010000100001000011100000011110010001011010110100011001011100001001
01000000001100000110001000000110010010000000010100110000111110010101010010001000100100000011100010101
11000000111100000001010001000001010000000100001001101000100000000110001011000101000001001101000000001
00110011100000101110100001001000000100000100110001000000011001001000100000000001001010000000000000011
00111100010010001011001001010011111110000010000111010010000000011100000001000100000010010000010000000
10001110100100000000100111101000011111100101011110000000010000100101000010101010001011000101111101100
00001110100011100000000000101010011000000111000000011011011101000001010010101100001000100100001010010
01000000110101011000110011100000100011011000000001101000000110000101000000100000100010010000000010001
01110101000000001000101101000000110010000110100000110001010000100000000100111100000011001100001000101
00000100000101010000000001000000000110100100100000110001100100001010011000011000000000000010101010100
00010100000010000100010001000100110101110100000000000101001100111110010000001011010110000000110000100
00101100010101111110000000100000110110000010000000000100010000010101000001000000000001001110000010000
00000001101010010001001100110011001010000001000001001000000001011000100100001101000000000100000110000
00000010010101101011011110010101001011100101000000100011100101000000010000010110011100000100000010010
00001110010000111010010111010000000001001000000000111010110000000110100011101000000000000010010000000
01000110111000110101101000000101000000010000001000000001001011001000000011010000000011001001000000001
00100100001000000011000110000010011100011000001001100000000110001100010001010000011100000100010000010
01010000001000110011010100010100000100010011010011001000010010000111000100100110000100110101000000000
10000011010101100001000001001011010010110101010000000111001010110000000001001010010100000100001100000
10000001000010100101100101001010001000100101000000001000001010001001101000100101010010000010011011100
00100010101011100001010000001000100000001100100001001100101000010101010010100000000100111100001000010
11001001000100100001000001100000100110100000010100101000001000000100000000100001110101010000000000010
00000001011000000001000000100100100000011010100001001010110100001000111010101000011110010011000001100
00001010010000000010000101000001000100010000000100000110000101110010000000110001110101100101000100000
10010000100101000100100001000100101011001000100100100000000101000101000000000010100101000101001110001
10000001100100001010100101100110111100000001000011000111100100011010110000110101100001101010101000001
01100100100000011010010100111100010001000101000110000010010101001010000001001101000010101010001010011
00000000001110101100010100011000000000001000100000000110101001001000000000101101000010000100100000101
10111000001011000001000001000100010000100011010001101101010000000000000000111100000010000001000000001
00010001001101000100100001000001000001100110010101010000011000100010000000001001000001000010000000100
00000010100000011000100000101100000000010001100001110010111101001001100011000010000000100010000000000
00100000000011000000110100000101101011101001000110000100000000100000000000100000000111110010000000000
00000000000010000010100000010000010010110100001001100001000110011000100000011000010110001001101010010
01110000000100000100101100100110100101000000100011110100101100011000110011001001001100101001100010000
00010001100100000001000100001001110010000110011001001000000000000111111000001000100110000100111000111
01100001111001001100000010100000000100111001100001000001010000000100000010001100000010100000010000001
10001010011111100001110010101000011100001100000100000000000000111001000001010010001110011100000000000
00001010000000000100110110000010100001000000000100100100100001000110100000000000001010010010000111000
01110010110010101101000010000100001110100001000100110001000000101001010001010001001011010110100001000
10000000010011010001100010010000010011111100001001000100001000100000001000010000010011001010111010110
00000010110101001000000000000010010100000010000000001100010000100000000000011000101001000000100110001
00000000010010000000001110100001000001001110100000011010100010110101011000001100110010000010001000000
01010101110000010000000110001000100001110001011100000001100110100001000001000010000010000000000011000
00100000000000101110000010000000011100100010010001111000000010011010000010010110000000000010010100010
01100000000010000000010000001010100110001001010000101011100010100100001001100110000000010100100000000
00100010001001000000000010000000001000010000110000110010000100010100100001000001011100000000100000100
00000100100100000001011000001100001000001000100000110000110001010011100011100111001010000000010110000
10010000011000001000011000000000000110000000010001101101000011100001000010110110000100011000011100001
00100000000010011011010010001000001011000101100000000110000101101000100010100110000110110010000001000
00000000100110001010000100010000001000010001000001001010101100100010011000110001000001010000010000000
00101000100100010011100010100001000011000111101010010000100000101000000100100101011000000010100000001
01100101000110100010001000100011100000000000011000110000000100100010010000011100100101000100000010000
00101100000101011010000001010011001001001110111010100010000011001001001000100010000001011101111010010
11000000000000100100000000100100010100000111100001011000001011100000100110000100011010000100100000011
00010100000100100011010001111000110010000010000000000110100110100000010000001000011000110000010001100
00000011101011101000010011000110101000001000001110001001001101101000000000001100000000010000100010001
00000000001110000110100000100100010101000100101101010001001111100101111000000000000011100100001100001
00100001010000001010100001000110010000011100000000010010000010001000000001001010111000010010101010000
10001110011010100001001001000100001101110100001010101001000011000100010011000000100000010010000001000
00000000000001100000000001001001100011101001000010001100011000100000000000000000000111110010100000000
00100110000110110101000100000100010010100000000101010000000000100010000000000001100011010000100010111
01010000000000000010110000001000100000010101111000101000100000100100100100100110000010010011001010000
10100001000100000000000110000001000000000000010000100000001010010000000010010010010101000001110100101
