00000000110000001000000010100001000110110001001110000011100000010101100000010100100000001010101001001
10101000100111000000110111000010000100011111000100100000000100000000010000010011000100010000000011110
00000011000100110001000101000011100011100100000101000001000000111001011100011100000000000001010001101
01001000000000010010010000100001000000011000000001001000010001101101001001000100000000010110100010100
10111001000101100000010000000000101011000010001000001000101100111010001000100010101001010000100010010
10000000001000000000100000110001111100101100000000100100101001001010000000000000100000100111010000100
10010011010001000100001001101010101110101000110000000001000001100000010010101111110010101001000001100
10101010101000000000000000010010000100110000000000001110001110110100010010000000110001110000100100001
00000000110000000011010001100001000100011001110001010100000100010000010000100101010100101010110000010
01000100011011100011101010000001001010100000000100000100001001100000000000011000000000010100000000011
00000011010010010000000110101001101000010000000000010000101010000000000000000010110000000011010010100
00000010000000110100100100011111001001000101011000010000000100001010001000000001010001100000000000110
00001000001010010001011000110001001111100100011001000100000001010000001001000000001000001010000001010
10110000000010000000000101000010101110011001100100010000110101000100000100010110100100110010000001000
00101000010110110101001000001000000000000001111010001000011100101011001011000011000000010100000000010
10000100110001001111100000010000110100000000110110010110010011011000000001001000111100010100110000001
01001001110101000000100001000001010100100111000111110010100101001001100100000000100110100000000110100
00010000000010000110001001010001000011001000110010010100010000000000100100000001000000000001000010000
10110110100110000011101000000100000010100001000110000100111110001000100110001001000100000000001100000
00001000000001000010000000010001010000010000001001000000100001001000010000010100110000100010000010000
00000010001011000001000010000010000101010000010000100100001000010010010001110100000100100000000100000
01111010110100000110110111000001001001000100010000000000010011000011001101001000010000100100001010000
01000000001000010100010000000000000000000001001010000011001001001101000011001000111000000000010001011
01000001000110001100001101011000000000010000000100000000100001010001000000110000001010101001101001100
11001101010000000110001010101101000000101000000111010000101000001101001000000000010100101001001100001
00001010000110100010000100000100000101011000001000000000000010101011101001000011111001100001011011000
11000001010010000000000000010001000000010000000000001000100101000100000000010100010000010100000100011
00011000000100000111101000101100100100010001101000100010010110000000010011110000101101001100010100110
00000111110110101100000010000010000101000000000100000000001100100011000011100011110111000001100010010
00000100000001000011001000010001000100111100000000100100100000000010000010100000000100011000000010010
00000010011010010000000010001000010001010110001000000000000000100110010100010000001101010000010101000
00101010110001010001011011111111010100110010001000001000001000100000000000010010110000010000110001110
00001111001010110010110010000000000001010000000101101111000000001000000000000000000000011010101000001
00000000000000011001000001011001011000011001001010001000000000101110100100001000100100001101001011100
11010000001000110010101000000001001000000001010001000100000100100000001010101001010101010010101101100
00000011000100100001000101000000101000100000000000101100010100101100010011100010010000100000010110100
01000000111010100101001100000001001010000001010010000000100010101111100001100111001000010010000000110
00000100110100100000000100011011011011110010110000000100001000000000000000000000010001100000110111001
00001111001001000010001000100010100100100100100000000000101001010000000000100000110000010001000000101
10000011001000000101000000001010010000010110010000010001000000010001100010010100110010010001100000101
10110001110001011010100000110001100100001000001000000000010001110010010010101000111001100000001001010
01000100100000001001001100001110001001000011100010100000010001000000010100000001000110000101000000000
00000100101001100000001000000010101000010000000000010001000011101001000101010011010000000000100010000
01110000000000000010110110010010100010000000000001011001011011000101011000000001010011101000000010101
00011000001000000000010001011000000101010000101110000010001000100001100000101000101001010101101101100
00100001000010100000010100101000100001100100101010101000000001101000101000110011100000000001000101110
10000100000011000100001001110010100100101001000000101010000100001000100010011011000000001100100011110
00000000101100110100000011000110000001000010001011100011001001000011000010001100000000100110000000100
00010000001000001010001000000100000111100100101000001000010001000110000010101100001101110010010010001
00000001001000110000010001110001110010100100110000000100101000100100001111010011001000000000000001111
00101001000000010010010010000100000111010000010100011000011011100101011011000100000100001000000000001
01011001001100000000010001010100000010001001000010000001000000000110110000110000011000000010001000010
00001010100000000000111101010010000100000000011110000111001001100110100110001000100000110110011100010
00001110000001101000000000000010001100010011000100000010000011110000110000100000000010000010001000001
00111011010000101110010100000000010000011001100001011011010011000000001001100000101010111011000111001
00000110010010000100100100010100000010001011000000010001100000011101001011100010001000000000010000000
10101101001000000000000000010000000110010110100010001001010000110100000000100111100110100100000101000
00010110000010100001110000000011000000010100001000000100000101000001000001001000010001111000010011100
01000010011001011010011000111010000010010100111001110010010010010000111010011001000011110100001010010
10100000000000010000010010000111110100111011101110011100010000001000100010101101100000111101100000110
10000100001010000000110000010010010011000100101111010111010101001000000010010000111010000000101110100
00000011100011100010001010110000010001000000001101010010001010110100001011010110000100010101100010010
11000100011000000000110000001110110000001100001000101000101010111000000010001000000000001010010010011
00110001000100100000100001000100111101011001000110000100000101010101010000011010010010100001001000000
10000001101100000000101001100010000000001110000101000000000100011010011011000000000101101100000001000
00000100010000010001000000100000101000100000001001000011001100000000000100000001100011000100111110010
00001000000000000100010011110100000000000001000100001000010000000110101010010000111010100100101000100
00010101001001000000010010111001000001100000001000100000001010001000011000100000001100000001000010001
00000100000000000010000000000000001000000100100111001011010001110001010010010000000101100100001000101
01100100100001001011100010000110000100110010100001000010001100000010010100010111010111100010000101110
00010000010010000100000000111011010101000110001001000100100000000001000010100000100010000000001101110
01001101001000000000000111011000100010000110010000000011000100010000110001000001110001000111000100000
01101000101100000011011011001101010101110100000110101010001000100011001010110000111101010100010000010
00110010000110001110001100001101001011010101001000100000000000001000101110000011100100100001000100000
00001000000000110100000100000001110000100100000001110110100010010100101100110000000110010000010001011
01010001100010100000010000100000011011100000001100010000011000001111010011000000001010001011000000011
10100111001010010010100100000000110000100000000000010000001000000100110001001000100100000110010100100
00101101100000010000000001100010000001100010000100000110100000101000000000100000101000001001000000010
11000101000000111010010101110100000010001010000100000101100101011000000111000101010001110000101001110
00110010000100011010010100101000000000101101000001100000110000001010100010110000000000100001001001000
01010000001010000000100110000001001000000001010000100111101000001011000011000001100010010000001101000
11000001000110100110000000001010001001110000000001100101000011000001001000100001000000100000110000000
00100000100011000011101000001000110011000000101010010100001010010100101010110000110000000011010010010
00001000000010101000000000001010100100001000000000001100010011110010001001000000000010110101010000000
00010100000001000000101100100000010010100000010100001000010000111000110001010000010101000100100000000
10000100000100101001011000000001010010000001000100000000100001010100000111000010010011010011100000100
01001010110000000000000010000100010000011010100010101010100000000100000001001100011000000000010001110
01010010000000010010010100010100010110111100000100111010011110010000011000010010101011001000010100001
11100001100001001001011100010000000100000010001001101010000011010001000111001001000100011010000001010
10000000001000100000001010100111100111000011100000011010000001001010010010100000001000001000000110010
11001001110001100001101001100010100000100101100011001011001000001001110100001111000001011000100011000
00000001100100000000000101001000010100001001001000000000000101101010000000000000100000000001000111000
10000011000010001000110000000000010000011100100001000110000100001010000000000000000010000110110000010
11000110011000000000000110101110001010001000000100101100000010000100000110000110001000110001000010101
00000000001000100000000000001001101111000011101110000001100100001100000011000110010100000100101000110
10000001000000100011001000100001100111001001000010000010011001100000100010001110110100111000010011001
00111000000000010110100000010001000100110010101000010000000010000101000111001000100100010001000100010
00101000010000000000100000001111010010000001010000110010100101010000000001000000000001010100001000010
10101000001000000010100000010010100000100010001100000111100110101100000000010000011011000000100000100
01000110000000000100010000011000011001101000000000000000010000001010110101101001001000001111110000000
00000000010010010000000001100010001001000000000010000100001000000110100101110100010111000111000101000
