01001000000011000110100000000000000110100000010100100000000101100010111010000000110000110011111100000
00000010000000000000000110100001000000100000010010110111100001000001000100001000001000110100000000100
00000100110101010000000011101000000000000010010110100000000000100000100000000111000001110000000010000
00001100100100010100100000010110101000001001001010001011100010010111111001000001101000001100000100000
00000010011000000011000101100100100001000000000010001001011110001010001000100010000001100000010001101
00010100001010000001000100010000110111100000000000000000010010110000000100001000000111101000000010110
00100000010101011110000000010000101100100001010000000100011000000100001000000100010000001000000100000
01011000011110010100110010100000100000000001010110001010001010001000010010001000000010000000001001000
00010010001000000000010001110010101010000000101000101010010000001100000110000000101100000000011010000
00010000010100011000100000001100100001000001100000100000111010101001000001011001000011100001101000011
00010001000101101000000110110110110000100010000100001100000000110010111001000111110000010010110010000
11000100001011000100001000100101101010000101001010000011000000010111000101101000010010000001101011011
00000000100011000011100000110000110000000001101100010011010000101000000000000000000000100000000001000
10000101000100000001000010010001000101101101000010110000110100010001011000000000100010101100101111000
00101101111010010000101000100000000110101000110011000000000010000000000101000000000010000101101100000
00011011100101101101011010000000110000010100010010101010000001100100100111000001001000000001000100001
00000010101000000000000110111100001010010111110100100110010000010010110000011000010000000001000010000
00001001001010010010000100010110100000001001001010001110100000001000011011011101110110100100011011011
00100001000100000001000000101000100001100011111101000000101000001000100001001000001000000000000101000
00000110001011000100001010000000100000000000101000101010010100000000011100001000100010000000010100010
11010001000100101011001000000110101000001100011001010001001000000101100101010000100100000101010000100
00000101010010011000100011001000100101010000000101110011000000000001000001010100100000101010001010000
00110110001110100100111011011011001000101010000010011101010000001000000000100101000100000001000000110
00011000000000101100110010011000100000000000010100000000001010000100100100011100001001001111010000010
11101101000000100100001111001100100000000011000001000000010100001010000000000001000000110111001011100
10010000001000100101011000000100101100101000100001000010111000010001000110000011110000001000100011000
01000111100100000001101010100001000001010100000010110000010000100001010011101100110000000001001101000
00010000000000000100100000000111000000000001000000000000000001000011000100010010000100111010100001100
10010001001100001101000011000011000010000000000010001000000010010110000111011000000100000000001000000
10111011000010100100000000100100110100100000000111100010010100000000010000000000100101010010000110100
11101001011000001100000000001000000000100100100101000101011100100111000000110000000000100000101000010
00001100010110010001100011001100001111110111100010000001000000000011010010100110010010000100010100001
00010000110111000010010010101000101110001100010001010001110000010000000000100001001100000010001110000
01101110010110000010001010100000000100010100000100011011001000100000001000001010110011111010101000100
01100000011001010001000000010000011000000100000000000100000000000000001100111000000100000010001100100
01000000000101111011011000001100010100010100000000110000000000000000001001000000001000001000000101001
11000100010011011000010010010001111000000110100000100000101001101110111000000010001001001000101110010
10001000001100001100100000110101110000010100010010001100010000000011011010110010000110100001010000000
00011100001000110100001001000001000000101000000100111010000100011011100100000000100000011101010000000
10001001110011000100010000011000011001111011010110100000001001100011100010000001010011000000110001100
10000010010000010010001110000011000000000000100000010001000010000000010110000001000011000010001100010
00000000100100000101000010000000100001000111100000000000000100101001100001011001010101000100000000100
00000000000010010100110000101001101000001000010101010011111101001100011010010100101000000011000000100
10000100100110001000001010000010010100010001001100000001000001000001000011010100000100001000001100101
01100011101010000010010010010010101000001111010001000010111000000100011100000010010010000011001100000
00000001100100000010000000010101000001000110010000000100000001000111001000100000010010000000010000110
01010101001000100011100001100001010001001110000100010000010000111110000000001011010000011000001010001
00100000100001000100010011110000100101001011101101000111000101000010100110001000100001110001000000000
01001000000011000100001100000000011000000100011000000000100011000010000010000000000010101111001011101
11000100110001010100010100100001100100000011100000000000100110001010010000010010001011000000000100100
10000001100010010001011011100111000001000100011000000000100001000001001010001111000000000010000000011
00110000110000000101000000011100001100100000101011001000001001010001000001001000100101111000000101010
11111010100101101110001000001101000010100010110001011001010001000000001001101101101000011100100101101
00000000000000010110001110000101101000010101010010100100000010100000001110000010011000010000001010010
00011000111000000111001011111100110001000001001100000000000000010000101000000100000001011100000010000
00100111000010011001000100000100101000000110111000000010010010101001001000000001101010100110000100000
10100010000001100000101000101001001000001110100010011101000011000010110100100001010000001010010001000
01001000011100001010000001110001100011110000100000000001001011110000100000110010101100011010000001010
01001100110000001000000001001100100100100110000001000010000010010000011000010110001010010000010110000
00000011001001001001011100000000010010010100000101110000000100010010001100001100100101000101001000011
01010100011111010100110000011001110010000010001000000100100011000111100100010010001000010010000000100
00000110010100011000000001000100100101000001001001101000100110101100000000100010011110010000000000000
00100000000101000000000000000100011000000101000000001010010100110101100001100000000001010001001101010
01000101000000001000001010000010100000111010001000000000000001010000011001000100110010000100100000000
00000100011010000000000000011000101111010110001100000000000000101000000001111000111010110100101100001
00011101001010100000000100100000000100000001100110101010010011100001001000100110100001001000101100100
01000010100100001000001011010100000110000100000011011011010100000000101010001000000010000000101000000
00010010110100100000000010001000101001011101001001110101100000100100101100100000000101001010100010010
01000001010100000000010000000100010000000100000001001001010100101000000000010001000110100100010000010
00010010000000010000000100000000111000110101101111100011000000011101010000010000101100110010000000000
00000010001000110001000000100000100110001001001000000011011110000001000000000000010000101000010000110
11101000000000000001000010000010100000011001011111000000100110010000011100000110001100100000000101000
00001101100001101000001000000000001010001000010000010001000000000111000100000011000000000000011001000
10000100010110000100100000000100000010000001001010010010000100000110010000001101101010010011000100010
00000000100100010100000100001101100000010100101100110000011010000100011001001100000000100100000000000
00101010110100011000000000010010000000010010000010000110000000110010101000010001000001000010000011101
00001111101000000100010000100011000000010000101100100000000000100111000000000011000000100101001001110
10101100101100111100110101001000010000000010110010001100001100010001100000011011000000000000000001001
00000000010101011000111011000001000100000000000000000000000000000001000000010000000010111000010101011
00001100010010000000100001100000000100010110000000010100001010000101100000110100001010001000010010000
11000110101010010001000000001100001001110101010100101110100000001001000000001001101000000101000000110
00011110000011000010101000000000100011100110000010100001101110000000011001000110000000010000001001011
10011000100001001110000000010010100010000000101000000101011011110010000010001000000000011100000111100
00011101000000001100010111000001000101111001101000100000011000000100000101110011010010000000000100000
00000100101001001101000000000101000000101001010000000010101100000011100010100100011000010100000100001
00100010001000010101011000101100010000000101100000001000001000010010000001001001110100010110001011100
01000100000100000011000010010110010001000101100010000001000011000001000011000010000001000000011000000
00101100000000000100001000000100001010100100001100101000001100000011000101100001000010011011010100000
00100000000000001000100001000111000000111110001000000100101001000100110010100001000010100100010100000
01000010000001001010100001000011100010100000010000000110100000000000000000000000101000100001100101011
10000100100001101011001010000000001000000011000101000000000110000001010000010000010010101011010101010
10000000000001001010001010010100100101100001011011001001001001000000000001011010100000000010010011000
00000000000000001001100101001010000100000000100100100101000101011010000000001000001100010001100000000
00110100100001100000101010010000111000000010001001110000110001101000010001000000000101000011101010000
00010101000100011100100000010001000101011000011000001100011000000101010000100100000000101000000010010
00111010001001000010010110010010010110010101000000000010000110000111100110010000000000000100100000100
00000101001000000000101000100111100010001101000100001001101011000000011100010000011100001101011000000
00000011001010000011000100000000000100101011011100100000001100011111010100010000100110100110001100100
00010111011000100000011000001011010111110100000000010000010100000011100000100000110110000100110000010
01011010000010000000100100100101010010000011000001001001010001100110010000000000001000011010000100100
10000101100110001100010100001001100010100010110010000101011000000000010000101001000010001100101000101
