00001110010100111001000000100100010000000000010001011111000110010010011100010010000000100000100000011
00000100100000001000100101000100000000000000000110001000100001100001010100011100000100010010111000010
00110000001100010010000001111100000010010101001010010100100001001010000001000010110010000001100001001
01010000000010000100000001100000000000000010010000110001101001110010010010100010000000011010010001000
00100100010100110111000101101001010000000110001111010000010001000100101000011110010001110100010001101
00010100000010000010111001010100001001000001010000000110000010010010100000000011111101100010001100000
10000010000110100000110001010000100100101110000011000000011000101010000001001001000101000000010010000
11000100000100010000000000010110000011110000100110000000010000000000101111110011010100101000100001000
01000000100100010010000010000100111101000001000100000100100100001010011000110000111100110110100001010
01001000101000011100000000110110100010110001100000001110110010000000001000110000010000100110001000001
00000101010001010001010000001000000110000010000001000100010100000100000100011011000101000000011101001
01100001001100010010001000000000111001000000100110100001111001001011000010000001000001110000010111000
01010010101000100000100000010000011001000000100000100100000001000011110000000000100000000000010000001
00110001010100000000010000000000010001000000000001110000000000010001000000000101011100001011010000111
01001100000000000000000101011010010000010001001001101001000000000100100000100000011100000110000000000
10101000011001100001000101010001000110001010010000100001010001000110000011001100000010000011101000000
01010000100010001000000000000000001000100111100000000000100101000000011010010100001010000000100100000
10111000100111110001000111000010000000110000010100000001100011011100100101000000010011001000000010100
10001000000110100000000101000100000000001000001000101000010001100000100100010101110010011011010001001
00001000010000001001010001000010010000000000000100101000110100000100001011100011000111110001001100010
00000011000101001000001010000100000001000000000010010000001011010100001010000000101001100000100001010
01010000000101000100100001110010000011010110001000110100001101010000011110000001000001000011100000010
11010010000100001100001011010110000101000100100100010000000010010000010010100101100111000000000110010
11010100001101001100110000010000000001001111100000010001000001001100101100010000011000110001110000110
01100100101000001011101011000000000000000000001001000000000000000010100100000000010000001100001100000
00000100000010000010000000101000100100001000000000000101001010100001100100000100000100100010111000100
00100100111010010110000100000000000010010001100010110010011001100100001100110000000100000010000110000
00010100001011100011010000000110000010101100100000100000100000110001000000000010010011001111010000000
10100000000011010000100000000010010011001011000000000001110111000000001101111101000000000010000000010
00000000000100010100000001110010101100000001000000111111001101001100000000110001001010000000000000010
01000011110001000101110100000010100000000111100000001000000100010000100101010000000010000010010010010
00101001010000111000001000110010000001000000100000101011101000000011100000000001110000011111100001000
00110011010010110010100101000110000100010000001101010010000010001000000001000110001001010011010000000
11100001000000001101000100001000100001010010101010001010100000000001000011100000010101000001110010010
00000010010000000000001010000000000000100111010010000000101101000010100011000000000100000010000000001
10000111110101110001000000010010010000010000000010000100000000110001110001000100000000110011010011000
01000010001001101001111100100010000000100000100011000011101010100010000011010001000100001000110000010
10010110001000000010000101100100000010000000001000100010001001001111001001000010111001100000001100010
01010000101110000000000010010000010010000000001000101011010011011011000100000000001011000000100000001
00000101100110100001001111100000000001101100001000111100100111010011011010010010001000111001000011010
00000100010000011000000100000001011100100000000100010011010001011011111000001010000100011001101001100
11110010010100000010101000110001110001000001110011001101000101001001011010001100100110000111111100001
11001010000010000000011001100000010010000001000010001000001100000101100000000001001001010010011000100
00101111100000100000000000011001010001000000101001001010100001000110100000101000111001000000010100101
00011000000000001101111100001001000010100001000011000010000000010000000101100000001100000100101111000
11011001000001110001101100011000001010111000101100101000001001000000000110010101000100100000011000010
01110111010000011001000001100011000100000000110000000000100000010100001000100001000110000101000000110
00000000000000000001100000001000010000000100000110000001101000001010010000110100000100010110010101111
00110110000011011000100000010100100011001001100000110011001000100000000000001000000100000010000101000
10001110010110100100011110100001011010000000000010101100000110000001100000101010001000101011000000001
00011000010001000000000000000000110000101100001101000010000010010001000101011000110000001000000001010
00000000001000000111000011000000000110000011000000110001010001001000000010000000010000001100100000000
00000000100000000110000000101010000010000111101000000110000000110000000011010101001100100101001010110
10100001000000001000000011001000001111010000010100000000011111110010000001100001000000111000100000001
00100000100101010101000000000000000000000010011011000000110100000100110001000000100000001000100000000
10100000010101101000000101000000010000010000001011110001001000001110001101010100101000100001101010001
00000010110010111110110000000001000001010101001100100000000100101100001000101000010100000000010010100
00011001001010010010000010011010000010001000001000101100100000000110010110010000000010001001101010110
00000000001100010000000001000000100000010100100000000100011000001000000010111100101000010000001011100
11101110000000001110000101110000100001001110000001001111011100011001000001100000010000110001000000000
00000010010000001010100000000000000100111001101100110100011100000001010000110100000000000000000000111
00100100100000010000000010010000001110111100011001000000000100100100000010101100101100000001111110100
00010000100100100011110010110001010101101110001001100100000000001010000110000001010000000000000111011
11111110010101000100001100000001111000001101100000100001100001000000001100110000101100001000011110011
10101000110010000000010100010000000000100001100000100000001111000101010100011111100010000000010000001
11100100001100011000000100101000101000000000110001001000100010000000000000110000000101010100100000011
01100010000001000000011100010000001001010001100001000111000101011100001000001000100000010010100100100
00001110100000001000011101010110110001010010000110000010001101000010001100000001110100000001010000100
11100000110000000011000011110100000100001110000101010100000011011100100001011101111100001001011000000
01000000000010010000100001011001000000000001000011110001001001011001011000000000000000001010010100110
00010000000100100000010000000100000000000001110001010110001000010000010010101100101010010111010001000
01000100001100010011000001000001000000000001000111001100000010000100011100000000101110000010001000000
00001000011010010100000000000001010101010010000100100000100101101000111100011000000000000000000000100
00100000010011101000001001000000000000000100000101101001010001010011000001001100100101110001010011100
00110001110100001000001000001010011010100010001011001110010100010001000000100001101000001001000010100
10001001101000100011100110001011010100000000001000111000001010000100100100000000000110000000000010001
10000000100100000000010110000010010010000000011110000001101010011011001000011000001100011001010000000
10000101100110000000010110001011000011100101001000001000100001101001101000000000010000001101001000010
00000101000000000000100011101000101100100000010000000111110000000100000000101000001010010100101001101
00000110010000001111000001000101000000000000000000001100101000000100110001001110001110001000000000001
00010001100100001100010000000001100100111000100011010100011000001010000010100001000001001100010010000
10000011010100110110001000001000000000000000001110000011000010101110000001100101011000100100110100010
00010001100010000001000001101000000000001001000000001000111000000010100100100111100110000001001010001
00000010001100000000001100000010010101000000000100010100010001100000001000000000000000001011111000000
00001001101000010000000000010101011100010010000111000000001000001010000011000111110000000010010010101
01101000001010001001100000001101101101010010101001000000101000000110110110111010010110110110000000001
01000000001101000000100100110000001001010110000101000010111000000011001000001000000001000000000000011
10000000110010000110000000010010100000000000011001001000000000101100000011001001101110001000000001100
10000100011001000100001101000011010000001000000000000100110000000001110110100001010101000100001111010
01001001011100000010000000001100000000010010011000001001010001000100000000000100100010010000001000000
11000010111110100000000100000011100101000001000001000001011000100100000010100000000011100010001110000
00000001000001000000100001001000010001001000010000011100000000000001000101000111000010110110101111001
01110000000000000110000000000101000100000000000110000000000100000010000100001110100000011000100010100
01011010010000000100011100000001000011010010000000110010100000000000101001100000100100000100010010101
00100010110000100000000010011100110001000010001000111000000001100000000010110001000000000100000111011
10010101011000001001000010000000000100100101001010001010100100001000010100001000000110111000001010000
10011001000001001100000101100000111000111000100011101100010001011000010000110000111100110000100010000
00010100001100000001000000111000010001100100000001110000000000100110001001011010100001001001000000101
01100100011010010001100000110010100000001100000100000100100000110001101000100010001010000111000001000
11010111010011000101000010100000101101000001110100000000100100000001000011010110010100000001000000011
00000110100000000100001110000100000001000101101100001000010000000011101000010000000000000011110001000
