01000100010001000100001100100011001010000110000100011110010000100101010101000101010010100000100101011
10001100000000110000010000000011010000010010001011000100011001100000111000111100000000000010000000000
11000010000010000010110010000100100101001010001011100000001000000011111101000000001100001010001101101
11000001001101000111000110000000010000010010010000011100001001010000001000000101001000010000010111000
00000010111101110000000000111010100100010001000101010100010100100000100000010000000001000010100000100
00101100010000001011001111001100101000011010110001011000000010000010001100000001001001100000100100000
01100010001000000010011100000001000100011111110011011000000001000101010000001010010010000000110000110
11000100000010000100000001001000001010101001000010000011000010000000100011000000000010001101110000100
00010001001001000010100010000101000001000000010001000001000010010010101000101100000000000001101001001
10110001100110100000000000010000000000100001010000110000001001100000010000101100000100111000000000010
10000000000000011111000000110010000100100100010000000100000110100110001110111010101010101010010000001
00100100001001010110001000110000000000001000100110100000000100001000101000000101110100011001001101100
00011100011001100010000101001000000000010001000101111011010001010001000100101100000001010000011000100
00001000001110000000100000000101110110010000101110000111000000001100110010101000001000001010100000100
00000010010000101000101010100010110000000000000011101101110110001011001000001100001001010000011001010
00000010000100010000001010000000000101100010010000000010000000000001001010001010000101000101000001000
00010010100001011000100001000110001001001011001001011000000000111010000010001011010100000000010001001
11011000100011000010000001001001000000000010010010100010101000000011010001000010000001100001110100000
00000001100111100000011000000001000100100110000000101100000101010010000010110001000010101000001100010
00011010000010000010000110001111000100000000000000100111000010100011011010000110110001100011000100110
10010000111001001110000001100000000110000000000111100110010111010110100010100110110101100110010001010
11011011000001100010100000000000011110001000010001000100000100000000000001100001000101001010010000000
10000001101000000100001100000001010000000000110000010101001101000001011001011010000000101100000001010
00101000000100001000000010101010000010000000001001000000100000101010100100010000100110011000001010000
00101001001010100110001000101000000110000101010110000100100000100000110001000000100010100011100001100
10000101110001010000100000101110000010000000100010011001100000101010000000101110000100110100010000000
01011011100100010000000001010000000100000100010001011000100100100001010001000000111000100100101100000
01001000000000011011001110001011000110001000011001000010000100100001010100111100101010101000000111111
00100000000000011000000000111000010101000100100001010000000100101000000000000000010011100011100100101
01011010100000010001010010000110100000010111010110010011000100010001001100000000001000100001101001110
00110000010010000010000001010000110010001000000000100000000010000101010010000001011101000010100100010
00000000001000010111001010000011010000011001001001111101010110001001000000001000000101000100100101011
00000001000000000001001001100011011001100011010010011111001010000001000110000001110000000110000000101
01010000101000001010000010110010000001000000000101010111001001001001000110000111100000011001110010000
11100000001000000000000000100000101000100000000111000010000001000100111000100101010001001101110101001
00010010010011000000001010101001000001000000000000000011000000011000000000000001011100000011010000100
11000000101000000011000010011000010001001110000110100010001001100000010011101000100000100000000010111
10100001001010011101100000000101010100110000100001100010110010001101000100101000001111000100100110110
00100110000111000011001000000100100000111100100000010010100100100010000100100001000001001001000100000
00101100001101111001000100000111010000010011100000010111110011100010001000100000100011111011110000100
00010000001001010010001000011110010000001000001000000111010101101000100000010100000001010000010100000
00010011000000011100010101000100110011100010101000101101010111000001101010001000100000110101110000101
00001000000000110100100001000100010000001000010110011000100110001011011100000010000001111000000110000
11110000100000100100000000110001000000000000010010010100000001100000100000100011010000000000110010101
10100100010110011001001000000011010010100100010011000101000010010110100001101000010000100011011001000
00000001000111000100101010000011010011001100010000000100100000001000001000100001011001100101010001100
01100100000001000001001010110010110010100000001010110000100010001010110011010000101001110011000000000
10101110000010100001001010100100000001100100111000011000111000101000101001010000011000000110000010001
01110001011000100011000001010000000000100000100010000111100100000000000100100011011010001100000110110
10001101100011000100110010110100000000100011100100100000000001000000110101000100110100001000001000001
00101011000110010001001100100100001000001011000001100000000010000100101011101010011100010000100110001
11000001010100010010001010000000110100001001000101000000000000001001000011011000110010000000000010101
01000001010000110011000110010001011100000001000101000100011000010000001001111100100011000001111000100
01000000000001000000010000000100001001010100100100000001000111001000000000000010001000000100001100111
10110111110000111101101001100001010100011010010100001000001000010001000010010001100100000010100000100
00011000000000000001100100001001000101010100100101001000011000010000100110001010001000010111101000000
01001101000101001100001000010000100001000010101001100010100000000011011111001001111000000010000000000
00000001000000001010010001000110000000000000010000010011001100011000000000000010000000001010000010101
00000100001010100100100000000000000001001011001000000001100000010100011100100011010000000000000010010
10000011001101010110100111000000100110010011000100001000000100001010010110011001110000111000010010000
00010000010101100001000100000000000000010010111001010001001100001000101000001010101001001100010000100
01010100000000001110011010100000100100000000100110001110001001010100000001010010000010100101010001101
00100000000011100100000101000010010110010000100000000001010001001010100011100101001000000010000001010
01000000000011000100000101100111111111100000000000000000001001101100000001000110000000000011011011000
10011000010110000100001010000110110010100101111000100000000010010010011000010000000111000010001001000
11000010000000000001110000101110001110001000001100010001001000000001001110100001111100010000000011001
00010011100000000001110001000100101110010001000000000000100010010100000111000111010010000000000000111
01000011000101010000000111000001110100100100010011001001000010000000100010000110100111010000000101001
10100010010000001000111011000010000000001000101000010001110000001101001010000100000000101110000000001
00010010010010100010101000110000110010000000010000000001000000111001000000100001100000110011000001011
10000001111100010000000111000100100110011110110000001000001001000001100001000001100010000000000001000
00000101100010010100010010001001110001011000000111100000000001001010101000000000010000010000000101101
11010000001000010001101000000000101010111011000000000000001110010001001001011110011011101000000100001
01000001011100000001001010111010000010110011011011001101001000000011110010100000000001101110000000011
01000000111100011100100001101000000011000011110011100000000010100000011111100000011001110000000010111
01101010001100101010000000110000000100100100001000001110000111101010000011000101000100010101000110011
11011001000000000000000000101010010011000101100000101010101001110000110110100000011000000000001001000
00110010101011100101000111000011011101000010010010110010001000101100100001011110100000001000000000000
00000000100000000000001010000000001110001001001010101011000010010101011011110100000001100000000011001
00111000000010110011100001100000011001000010111101000011100100001010001011111000101000101001010010101
01010010000111010000000000001001100111111100010001010000010101100100101010000010100000001101101001001
11110001000101010000000101000000001001100001001011101100100000110010000011110100001000010100101101010
00000010000010000100000000000000000010100011010100011000000000011100001000101000110111000100101001000
00110010000000000100010110100001100001010101000010000101001010010000001110000010010110101010000101011
00100101001000001010000101001010010001010000000001011001100001110010000000000100100100000001001000010
01110000010000010000000010000000100010100111010010000001010101000000111010010000101111000000100000000
00000101000010000100101010000000000101110000000000101010111000001000000111100010000000000001100010011
00000010001001001000100010010000101111000000001000001100010001100000000000000000100000010010001000110
00100010001001001010001000001001011000000110011010101000110000100001100000001000001010010101000001011
00000010001101000101110001100110001001110000000000010000000010001101000100010010110011001000000001100
00101011100101001010000000010000000001011000011111010011100000001001000010100010001011010000000000000
00001000101001101101000000100000110100000001111000000000001000000000001001000100000111000011000010000
11000000000010100001111000000000110001010000010000000000101000000000001010100100000101010011000100110
10101010010010000000000000000000000110000000000110101100100101000100000101000100000010110101011000001
00010110001101101010000101001000010001001101111000011100010001000110100101001001100110100000011000111
10000011000000000100100101000100100111101011000000111000010000000000111101010110010100111011110001101
00000000000000000011010010000001000111001101000000010100001000110100000001001000000010110000000101001
00000101001000100100000000000000100000010001001010000100100000100100000000000000000010111000010011000
01000010001000001100101110001100100111001010001101000101000010010000001000001000000110110100011001110
10010110001011000100001100010000011100001010000100110000000000000100010000101010010000101000110000100
01000010101001110010010111010111111000010000100101001010101011010010010000010010001100000011011100001
