10100010001100000110000000010000011010000000000001100000010000100100100010101100101100000101000000100
10000000001000011111100010000110000100001000000010011001110100011100100001000001010100010011001111001
10001010000000100100000100000000010100101100101110010001101000101111001100110000001010101011100011000
00111010011000011000100001000010100001001000001000100001001001100111100010010110010111101000100000000
00100110010100100010100010001011001000100101011010001000011000100000011101010001001111100001001010001
10000000010110001000001001000101000010010001000001101000001010010000101010010000001100001101001010011
01101100001011011000100000000110011001010011000100110000100001000000000010000001100000101100100001001
00000100001011010010101000001000010110100101101001100100000000110110010100000000101101101010001000000
00100000000000010000010110110100000101100000100001100000000011100010111000001100000000000000000100001
10101000011011100101011100110010010101101010000111011101000001000100100000101010000100100110001000010
00010001000010001000100011000010000000000000100000001000100000100000000000000001000110000110000100000
00010000100111100110100000001000010001010000111010010001101001000000000100110101010000100010010000000
00010000000001000000100000011000100100000101010000000000001000000000100001001110000000110001110010000
00000011001000000011000100000001101000000000001000100110100100011000001001000000001010100010100100100
01100000000101000001000111001000010001000001000000010010101001000000001000000000100010010100001100101
00010010100100011000011111001010111011001000100111001100000001010010000010011110000010100100100010010
01101001010010000010110010000001110100100000000011101110110001000100000010101000000000100000100000000
10000100010100100001000000001100000000000001000100101010100010011001100000000100010010100001110100001
00000011001100100000000010100101011000000100100000000011001110111001001000010000010001000000111011001
00100000110010000000000000010000010000001000001100110011010100110110000010010001010000000101101001000
01000100000000101110010000000110100000000000101010011001000100000010000000100000000001000000101000010
11001011001001110010001110000001100001000001000000000010010000100000010010011000010100011100000000001
11000101001100000100001101011001010100000000001000001000000010010101010110100100000100010001000000100
00100100000010010100000000000010100110110100100111111000010101000000010100000101100001000001010000001
11111100000000000010000110110000100000100111000100010001111010000000011110000011001000110100100011000
00010000111100011000010001000111100000001000100001010010100111010001000110100101000001000110100100000
00010000000001011000000001000000110000000000000100100101000001000000000010010110001011000101100001101
00000001010000000001010001010010100100100101100000001110010011000001000010100001000000001011111010000
11000010100011011110101111001101000010000100000101000100100010001000000011010010001100000000001110010
10010101010001000100100001100010101010100110010001110001010000000010011101100000010001000010000000100
00001000010000000110100001000000000100000101110000011000001010010100000001011000010000000010000000100
10011100001100101100110010100111000000001000010000100011110000100001101010000100100100001001000010000
00001000000000000110010100000000000101010001100001100000000000000000000001000100101100100001111010000
00000010011011011000001010000001101111000000010001100000000000000001001110000111001101010110000000101
00001000000000011000000001010000000001001000001101000010100011100000000100000010011010010100010100000
00100001000110000110010010101100011011000101010010000100000001101100000001000010010010100010000000001
00100010110000100001010000110101000010001111010000100000100100010010010001011000100001000000100101000
10000000000001010111011100001000110001000011100000001000101011000001110010011000011000010000011000000
01011000001000001000100001000101000100100001010001000001001010010001100001101001001100011110100011100
10011010000100110100000110100011000011010010001000010000011010000001000010001100100101011110001000010
11001011001010000000000010100100001001101000100000100001100010000000001100000000000000111000000000010
10010010000010010010000000100100111101101001100000000011011001101011001110001000000000100001110000111
11001011110110000000100001000000000000010001100000000100000000000100011100001000001101111001010100001
00000011010100000110000011000101100100010010010000000001011100100000100001000100000011100101010001011
01010101000100000001010000101000100101001100100000001010000111001000101100000100000000100001100110010
00000000001001000000010001011001100000000000001000000000010011111000110000000000011001000000010010010
00000110001001100011011000000010001000001001001000000111010100011100000100100100000001000000000001100
10000000000110110000000101010100110100100011010100000000100101000000010011000100010000000000100001001
01000011001111100010110100100011010101000000100000101010001101110010000100000001111001100110000100011
01000000110001010011100001000010010001100101110000000010001111001010110110000101000100000000000010010
00101001010000000001000000011101000000010000001100000000001001000000100110101000000000011010000000110
00000100011011100001100001001010010001000000000000000010110000100000011000110000110001100000000011000
00101000111000000100001010011000000010110100000110000000111010111000100000000000110000000000001101001
01100100010000000000100110000010110001010001000000100000000011000100001000001111001000100000100010000
01010001010000010000111100000010111000101010000011010010010000001010000101011000000101001000000110000
10001001010001101101000001000000101000010000001010010100000000000100000100100000100000011000011001000
01000100000000000100001000000011000000000000000000000010100000111000010000010000001001000010000110000
10111010111011111001010100010000010001010110000010001100100110001110000000100100110000000010000000101
00010000010100010111000011110000000010001000100100011000100010001000000010010011000000000000010000000
00001010011010100000000000100000101000010110100001000010101010101001000001010000001100000101101110010
11010000100111110000001111000000000001101111000000000000000101010110000000010100010100001001000000010
00100000111000001100100000000000000010001010000000010100001100000000000001000001001010111000000001010
00111000011001010100000110000110111000000110100000100000001000011001000110011110110011011000010100010
00010110101100011001000000100110011001010011011101101100111010011010000011110000110001010001001000100
01000000101000000101001011000001101100100011100001110010000010001010000000100101000100101000110101100
00001000000101100011000010000001100000000000010010100010000000100010010100001000101001101000000001101
11001000010001001000000010110101001000011100100011100100000001010111001000000100100000000010100001010
00110010111010011101010010001010100000011001001001000000010000100110011101110000100100100000010001100
00110000100100000000000101010000000001111010000100000001011000000000000111001110000100101001010001100
11101001000100000000010010010011101000000000000100000000010000001011000000000100000000101000100011001
11000001010100000010000110000100100000101000110000000000000010000111011001001000000001001000000010000
00101000101010010000011110010010111000000101001010010100100100100001100101011000110000001000011010000
01001010001010000001101001101100100000011010000010010100100000001001000100001000000001011101010100101
00000001000100000001110001110101000001000100011001101000001100010011000001011001101010010011110000010
00000100001000001000000000010100010100010100010010110000000101110100001000000011000110100010110001001
00100000100000100010010101001001101000001001000010000010101110001000010100000011011000000001000010000
10001000101110000110001000100000000011000101001101000000100010000101100000000100001000010001000100100
00100101010001100001011000011100110000010010100101000011000101000000010001000000000110000000011111001
00101001011000011001010011000000001110110000000000000010010100000100000000001000010100001100000000000
01000001001000000000001100100000000101100000001000010100001010011010000000000000000100001100000010000
11010010010001011100000011001000001000000010110010110000000001000000000000010000100010110000000000100
11000000000101001101001100000000001110000000001110010000000000000101100101010010001000001010001000001
01100001001100111100010100000101011010101001000000001100001010110110000101010100110000010011010110000
10111010011010110011001101010000000000101100000000001100000010001100010000001000010011110110000110101
00000010000011100000000010011001000000010100000111000001000100110000000010011000000000000011110100101
00100110101000011000000000001110000100101000100101000101111101111001001000100000001010001011011000101
00100001110100100000110000001000010010010110100100000010000010000000000000000000001010101110000110010
11000010001110100000011001000001101010101001000100000111001000000110100000001001000001101011001001111
11001100000000101000001011000100110000111001110001000011000100100000000100000101000100110001100111000
11100000010000000001010100010000000001000000000100010010001001010111110000001011101110010100000000001
01000100011000011010001000110000110001101000010100001001001000010000000111100010000110000010000000100
10000001000000110000000011000100100010001000011100100000000000100010000000110001111000010100001000010
10110001000010001001000010000111000000100000000110010111100000000101000011000101100000110001001000100
00000001000000100100011000000001101000100000101001000001100000000000100101110000100100010000011010001
00010000100010000011001000000000000110000100100000000000011100000010010000000000000101001100101001110
10100000100001001000001100101000001000001101000010000000010100011000110000000001010000101010110001010
01001000000101000001111110100000000000110000000101010010010111001001000000010010000101000011100000010
00101001000100000001000010011010100010000110001000010001110001011000100010000001000000100000100001101
00100001110000100010101100000100000001010000101101000000010000011001001000001010001010000000011110001
00010000100110000101100100000110001001100000000111100001010000100111101100001100100100000001001000000
10001000001110001110111000110100010100010000000010000000100001000010000100010000001010000010100000100
