00100001000000000000100110000000010110011000001101100101000110000100101000010101010000101000110100011
11010001110110100001010100111000000101010000101000010000010011010000001001001000101010000111110110000
00000000010100000000101000000110000100001000001000010010000000011000101001100001010101100001100000000
10000001000001010110110100010000001000000101011011010100000011000011000001011010100001000100000011000
10001001000010001001000000001101101011100000100001001001010100010001000110010010000000000001010000010
01000010010000101110000011000001001001100001101011001101000000001000000000100010100000010100010100010
00000000000001000000101100001011000100000010101001010010100101010001100001010100100100001100000001100
00100100010011101010110000010000011100111000000011000000001000000100001000010001100110011000101001000
00001000000000011000110000010001111000011000111110010000100000010001100000001000101011001001000011101
01110001001010011110100011010010101001001011110010001000010000000101000011000010000110010000100011010
00000000001110000000000010010001100110110100001000000100000000011111001000000000110100010000101011011
00000000101001001100001110000000001001101100110110000000000100011010010100001100010000010001011100010
00010000001001000101000110000000000001001000000000010000011001100000100000000000111101001010000000000
00000100001000100101000111001001001010100010000000100010010000100001010001001010101001000001001000000
00000000000001101000100000010100100000000000000000010000100010010101101001100101000000000110001101000
01100001100000000000010110011010000000100001010100011001101110011000110110001100010001010000000000011
10000000000010010110000001010110000001001110000100000100100010000000000000000100100100110001011001100
00000000001000000001110000000101111000010100011110001000111100010100001000110000111011001011000000001
10010000000000000000100001000000000000010001101010111100000100100001011010010001010100001100111010010
00000000000101010100000000010100000110000000010100100000010010001101000100010001100010000000001000000
00100001000000000010001010001110001101000100110000001000000000001100001010000000000001000100000011010
00001100010010000100000001100000010011010001011111000001000000001001010110010001000001010100001010100
00101010000000000100000101110000010000001100001111000000100100000000001000010110110000000101000001100
00000100000000000000000001001011000001001010100001011101100000000000110000011000000110010110100000100
00000000001101101110100100001101000101100010001100100001001110001100001100010101001100010000100100000
00001001000000100100110010000011001010101011001101000001101100100101001100010110111111000011000000110
00000010100100001100100000101000000100001001010000101000000101010011111001110100100111000000000110010
00000100000000000000011000100000000010000101010100000001001100011000010011000001010101001000000100001
00100000100100010000000000000100100100000101001000000000111101010100000000000001110010000100001000001
00000001110000000010101010000100000000000011110000000010000001010110000000010000101011001000100110101
00100100110010101000001000001000011110011100000011000101100000011100000000101110100011000000000010010
00110110000000010100001000000001110111000110111001000000000100000011100001001000111101001001011000010
10001000100000111000100011010000001010100000111111001001000100110110001000111000010100000010100000001
10000001100000000000001000010001000000001000000110101100110100000101100010000010000010010011000000110
10101001000010101000111010101010110000100000000001100101000000101000101001000011100000000101000001000
10000000101001000101010100000011101100011101010010000000010011100111101110100000010000010100000000000
00111110100110001010001001000000100011100000000001001100100110001010000000010000000100110011001001000
00111000000000000100001010000111100101000000000010010111001000110001001010000000010000001000101000110
00000110000000000000110001000100100000000000011000000000001110001101010011000101001000010010000000000
00001100000000000100000000000000111010000100000001000101000001010000000110001101001010000000000000101
00110000001001100000000001111011000000000010000101000100000001111000000100100100010010100101001111000
00001000000001101010101001100000110000001000010001110100000010101100000010011000000000110000000000000
11100000100100000010000100000010000000000001011010001010000011010000010001100010000000000000000100101
00000001000011100101000001011000000101111010010000001100010010011000000010110001110111000000101100000
00010101111010110100001000011001010001100001010000010100000111100000101101100000100000000011000010011
01000100100101000100010100011010000100111000010101000000111000000000110001100100010100100110100000101
00110000010001000100001011100010000010000000001000000001000001110010001000100000000000001010110010000
00010010011000010001000010111100100010001111101001010110000100001000100000000000010100000001001010110
00000000000000000000001100000010001000100100100000010000001100001000010101000100011010000110000000001
01101011010100111100100000100010100100000000000000011000010011000110110100011010000000000100001100000
01110000001000000011100010000001100011000100010000100111000000011000011000000000000000000000010000001
00101000000011101010100100000000000110010000100100000001001001000001001010001100000101111010000000000
00001001010000001000001000000001110011000010000010001000000011001000001001100100101110000000001000000
00000000011100011000010110001000000101100010001010000110100001010000111111000000110000000101100001110
10100010001001100010001100101000001011001000000110010010000000101000100001110000000011100100100010100
10111000001100111101010110001001100111000100011101000000010011001011101001111001000001000100100000101
00001000000000001010000110100000010011010110000111001000110100011010000000010000000000001000000001001
00001010000010000011001001001010011111001010000111110000000010001010001011010110011110000101000011010
00010100001010110010111100100100110101100011000001000100000000100001010011001110010000000001001011010
00100010000011100110000000101011000000001000010000001101001000000001010001000011010110000000100101000
01100010100000000000001000000100000100001000001010011000110000000010100100100001101000100001000010000
11001000001001111001111100110000000000010000100110110001000100000100010110000100000000000011010110000
00001000000000000101000000010000101010100111001101100100001001000000000001100000100000011011000101000
11110100000010100000000100101000000000010000001001101010111101000001000111000010000011000010000101100
00000101010000000100000100000100001100100000000010110100000100101000000001000101110000010001000000000
11000010101000010100110000000010000000100010100000011110110100011000010000010011010000001000000001100
00000001101010100100000000011001010100101000000000011100000100100001011110000100100000000000100000000
00100110000010000001010000010010001001001000000010100111100000001010000001010000000000010010111010000
00100011100110000101001111000010010000011110000010011000000000011010011010000000010000110111001101010
01110110000000001011011000000100100001010011001001110001100000010001000000011001110110010100001001000
01001100010001100100000010100100001101010000000101100011010000101001101100001000010000001010100100001
00010000000101100011110010100000000010100101100001100000001100000100100001010000010100000101101000000
00000001000110101100011001000100000000000000100111000000011011010010000101000000001000010000101000010
00000000010000010001000001010100010000000000011111000100000100001000101110111001100111010101001000010
10000100100001000011111011001010110000101001000001000001001010010000000010000000000000001001000000000
00011111000101001110001110110000001110001100011000010101110000010001101110100001011110100010111100000
00100111001100001010000000001001010101011001011010110001010000001100000100000100001010010111010000010
01001010000000000000100011001010000100111000000001100010010001011100010000011011001010001000100000000
01100000000011111001010100001000000100000000000000001100100000100111010001010000010110000000100010001
10001000101110000100100000000000000011000101101000100010000100011000000010001010010010110000100000000
10001010010001010000010000000000000001000100000100001001000010010011100100110010000010000011000000000
11100011010001011001100111011011001000000010001000110010000010011101000100011101001011000000110011000
00000000100000101000000100101010010011110001001100010101101000000000100100000000011101110010100000000
00010101010110110110010010001000000000001101111000100001100010000100001000000001100001100000010011001
11001010010100001100100000001000100110010010000000000111010000001001100100110001000011000000000000000
00000100100110001100001010101010010000011000100000010010000000000110000001001100001000101100000000001
11100100010000010001010111000000000010100001110000000000101000001000010010000011000010001010000000000
10000000110010011000010000111100010010000001001110001000011001000000100000000010010010010011000000000
01110000110000000001001000001001010110000000100101100001001101111000010000010000000110000100000010100
10000000100100011001101101101001100001001100110000010111110100000110000000000010010010000010000100110
01000111111011000001000100011000000001000110000101100001111001001001010001100010000000100100000000111
10100010000101001001001110100000000001010011101011000000001000000000001000010101000110000001100000000
11011010001011010000000000010001000110000100000000000101100000000010100000001010101100000010000001011
00010000101000000010101101000110001110010000001001100101001000001100001100000001001110010000000100011
00100000000001010100100000000110000010000010000101000100000001010101110111001001110000000001000000110
00000000000011100010110001101110010001000100000010000000010010000001000000000000000000110110100000000
10001000001000001000000011111001001001000000100101101010000110000100001010000001000000001010101000010
00010110000100110001000110001010111010000011001101110000001000100000101000100110000000000010000101100
01000000000000010000010011000010000011100000100000010000100001000001001010000010010010000000010011110
00011000000000000000101000000110000001000101010111100100000100110001100011001101011010011011110100000
01100000011001001000100100001010000000001001001011101010000001100100101001100000101000000001001000000
