00010000000000100000001100000110101100010100001001100000000010100000010000000100000110000001011001010
00000010011000110101111011001000010000010110101000010110010000000001100010001000000000100010010000001
00000100001100100000100110000010010100101110011100000000010011000111000000000001110000001000000101001
00100000100000100100000010011000000000000000000001001100000000000011010100010100000010111000001000001
10010000011101101101000001100010000000000000101000001001000000001000110111001000010000001000000111001
01001000100001100011001000110000001100000111010000000000100010000000001000000100000101001101000000000
00100101000100101011000000001010110001101010000000000101000100000111000000001000100001011011111000101
00010000000101110000001000001010100110101100001010010100100010010100001101011101010101000011100001011
10110101101000010001000100011010001101100100010000010000001000000000000100111000001001001010110001000
00101100011101000100010000000000101000000100000000010000100001000000001001010000110000100000000001010
00100000110100000001000001101000010000100000011001000010000001110000101110111000000100000010000001000
00000000101011000000000110110101010101000010000000000010010001000000000011010100001100111000010000000
01010100011000000000000100110000000001100000100001110000101000101100010000001000000100010110000010000
00001100101000111000000101000000001000110010010000010000011001000000000010010100000100000100000000101
00001010100001010000010011111000011010001000100000100101010001010000010001010000100110100001001100000
01001000110001100001001010001100110100000100000000000010010001000000100000000000000010000111000000000
01000100010000000000000000000100000001011100010001100000100000000000000101101001000001000001100101000
01010110010000010111000000000011100110101000000010000000110001010000000001110110111000010000000010000
10000000010001010010110110000001110010011001000000110011010110101010000011010110000101000000001001100
10000010001010010110001110010010000110100010000000100110001000010001110011110000101000100000111100010
01000011001001001101010001011011011010001001000100010000001000100000000010000111000100011000100001100
11000000000000010010011011000010000000110001000001000000010000000000011010100011001011100101010111010
01000001001000001100110000100000110000000001010110100110011010100000100001100001011000011100001011000
00111000100010001000110000010001110110000101000000000100000000110010100000001110110001010000000010011
00010100110000010010000000001100000001001100100101001010010001000000100001100011111111110100110000000
00000010010001000001010010000001110111000000011100001000000010110000010010000001000000100100000000000
10010010000100001011000001011000000011010101101000001000000000100001000100011000010100001000011111111
00110000101000010000101001010000000110011000001000000001000000000100000000100100011001011000001100001
00010010101100000101010000000000001000100110101101000010010000000010101101001101111000100011001000100
01000000000000100000110000001001100000001000000000000110111010000110100100000001000100010110010110110
00011010001000011000001110001000010101001000001001100010100100101000001110000110100000000000001000000
10001100010010100000000010011000011000011000110001010101001100000000101000000000000000100000000000000
01100010100000101100000011001010011001110010000000000100001011111100010011010010100001100011000010110
11011000000100000010000000000001110000111000011010100000010001000100100000000100100001111111011100000
00011101100000000000010001111100010000000000110001000001000011000100010001001110010010000100000010011
01001010010000010000000011101100110100000100100001000010110100000000001000010110100010000101000100010
00001000001001000100000000110000000001000100000100010010000111001001010000010000001010001011000000010
01010110000101100100110010100000100001100000001010000010110010010110000100000010011100101100001100111
10010000001100111000001011000000011110110000010000010011000101111100100010101101110110010001000000000
00100100101100000100000100000001001000000001000011000001000000010001100100001000000010100010100110010
10001110011001000110001000000010001011000101010110101000110000100111010010010011100000001100110010000
00101001000000100000001000000110010011000110101000010001000011101000001000001100110110000100001000000
10100110010000100001111001010000001111100001111000000101010100000011000000101000000000000001001110100
00001010000010000000100000000000001000001101000100111101000100110100000011100001011000000111100001010
00111001000101100101000011100001100010100110000001010000001101000001010011100110000000100011100000000
01110000001001010100000100000000000000000000010000110000000000101000100001010101010001000110000010001
00000010101011101001001101011010100010001000001000010000000010000001101010010010010000010111010000001
01000000000000000001001000100001010000101010001110011000101100001110110000110111001001110010000101010
00100010011011101100001100000010000011001000000000111010000010000000101110110000000000000010010000010
10000001000011000111001100010001000000010001000100011000001000000111101110000000000000000000010000101
11011001001100100011010010100010000010011000100000011001000010010000000101110000000100000010010000110
00010110001100000001110001000000001111010000100100000000000000011010011000100010110000011101101011110
00000000010100000000101001011010001000000111100000011000010000010001010100000101000000001111011001100
01100101010000000011000100100010011000010010011010101010100101100101011110001000010100001110000001100
01001011100110000011000101100001000001001010101001001000001000001000000100001000000100110100101001010
10000001000000010000101000000010001111001100000000010000000010010101100011000010000101010001011000000
00100000011010000100001101010001101100100000100010110011010100100001110001010100011100000011010000001
00011010000000011010011011000101011001010000011010000000010010100000000001001100110100010101100110110
01001010100000001001010000001101011010100000010100100000000000100010000001110000000100010000010000010
11011000011001001100001000000100100101011011000000100000010100000011001000100010011010001000000000001
00010000111001011100001010101000011011010101010100100011100101000001000101010010000100001101110000010
01110001100010001000000001010000000110101100101001010000001101100001011111100100001011001100101000000
01110011001010010010010011001010000100010010010100001000000011000010000011000000000100100000001000010
00001011011010111010010011000001000010100010000000000100000000010000001101000000111000000000010010100
10011000010111110000110001010011010000110101110000000101000101001000001000100011000000001000011001000
00010010000110000000010100100000000001100000100001100110000011010001000001111000010000011010011000000
00100011101011101000000001011001110001000010000100100100000000010110010101001000111010010000001000001
00101000000000000000000011011010110010101001000100100000100000000001000010000000110100010100001101000
00001000000101000000100000001000100001000010100001110001000000010000000110111100000100100001001000101
10110000000100000010000001000110010000001011100000110011001000100000010001011001000010010110000010000
11000000001100100010010110000110111100000000110100100101000101100110001011100011001000100000001111110
00001001000011111011000000111100000000000100101000100100000001100010110110100000110001101000111000001
00010000001101001111100001001110010000000001110100010000000001110010011111010101000100101000100110001
00000110000100000000000010100001000001010000010000110101100010100000000000110001100000000010100000100
00100001001011100011110001000000100111110100001100000001001000001000001011010011000000100011001011000
01000000000001011100101011011000010100100010100000101010101100100100001000001111100000110000000001011
01000000100001100000010001001101001101001100001010000010101011100110000010001010000001000100011000110
00000001000010001001000000100001100010001010011000010000010101000000010100100001001001000000000110100
00100000100100100101000001001010100000010011110001011001100000100101010001001001000000101000010010001
00010001000000000110000100000001000000000100000001000001000000000010100000010000001000010110110000000
01010110111010000000110100000010000010001100010010001001010000000000010000110101000011111100000100100
00011110100000000000100101011100001010000000000000011000010111101001000000111000100011100100001000100
00000110000010000001010001011011010001010010001010010001000011011100101000010000001100100001000010100
10100110000011001010010100100001010001000000000000000000001000110010000000010100011000000000011001100
10010000110000001000000000010000000000000111000110010000101100101100000000010100001001010000001101000
00010000000000100100010100000110100011101000000010011011011011100100110100001101100001011000001000000
11100100000100000000010110001010001010000110100011000100110000001110100000000010000100111100011000000
00010000000010000010001010100110011001011001100001100101000001000101000101100000100100010000100001101
10010011000010010000100101000000000000001000101000000010100000100011001010010100110000001101011001001
01010000000000000010001011100100000000100100000011000000000100000100010011000010101010001101101100000
10101011100011010000000100101000011000000000010000000110100000010110110010000010001101000001000000001
00000010010000001010010000001000101101000000011010110001010000010111010001001101000001010100000000001
00100000000010000100100100000010101001001000110000110100111000000110000011000101110101010000010110001
00000001000001000000111010000001101110010000100001010100000101000010100000000001000010001111101000011
01000000110100001000000101100001010010010000100000001100101011110110101001011000001000000110000101010
00100000100000010000000001000000000011100000000000011101010000100100010010000100000010001000001010011
00100100000010110000001000000110010100010110000010101000100010110010001001001001101000001000100010111
11001110100001001100000010100101001110000001001010100111110010010000010100101000001011100010001100000
11000010100000001010001001100010000001000010001011100000000000100000100010100000000001110000100100111
00000110001010001000001010000000001111100000001010000101010001000010010000000001010100001001000001100
00001001000111001011110010101010110111101100100000000000100100110100010000010010000100100001000000001
