10110001000100000010101000100000001100111010010101100000000000000100000000000101100100000000000010011
00000010000100010000000100011010000000111001000000000000100101001000001011010011000000000101001000001
00000000011000000010110001100001010111000001110011000100010000100011000010000000011000110000000001000
00000000001110100011100000001000000101000000110100000011010101010000110100010110001100110000000011001
00100100110010010100100000101001001010000100110000001110100011000000001000100000000111010101001001101
00100000100000000000000001000000000010101000000110101100010010100000011010110110001001011000101100000
00010010000000011001000101101100000010000100000000111001000000010000000010010111010110000000011110010
10000000011000100000000111000101010111000100100001110011000000010001000110000001100010001100101000001
00000110000000000000010010011010000110100000101001100010100000011000000110111000111000001110111100010
10010001110000000100000110100111000110000010001010100001100101010001010110010001001000100000110000000
10110100011100000000000000111001100001000000100100011000010011010000010101000010010001000000100000000
01101001001000010000000000000101100100110100001010000011110000101011011110000010101000000000000100011
01000100000000000000000011011101000000110010011000001010000010011101000011000010000011001010110010000
01010100000000100000000100010010000110100000010001011100000100100100000100000000000001011110100011000
11010111011000000000010000001000000010110110100000011000001000000010000011000001011110010110000000110
00011100101000011000000010001010001000001000011100001000001000010001010000001000001000110100000000000
00000000010100000110100000100011000000100000000000100000100011110100010001000000010010111000101000110
00010000101000101101001000100001000100000010001001001111001000000000100011101000010001010001011000010
00000001000000011010011010001000100100000001100000110000100100000000011000001000001101000000010001001
00111011111000111000001010100000000001100010100010000000001110000000010001000000010010101001001101000
10010101000100000010100010001101010000100011010010100010000111000000000100000010110000000111001010110
01000010101100010001000000000010000010000000100010100000001011000000000010000001000000000010000000010
11001100010011001001100000010010010010000010110000000001100011000001101000000010001010010001000010000
00110000011010001111101010110000001000010100010100000010010001000001010100100110100101010100100000100
10101100000110100000110000000000110001100100000010101100001000000011010100001100001000000000000010100
10100010000000000111000110010000010110010000001000010000011101000101000111101110000100010100110110101
00100001000100000001100000001110010001001011010011000011000010101010101000010110000010000000000000100
10010010111000000100010110110101000000000100001100000010000000000010000100110000011000000111000100000
10010000001100111000001001001000010000001000000100001011000000010101100001000000000000010101000000000
10100000001101100000001010011110000000000000000011000100000100111001001000000001000100100011010000010
00000100101000101111000100000100100001010000111010000011010110010100000000010000001101001010110001001
00010001100010010101000100000011101010110011101010010100010011110000011000010000110110010000110000000
00000111011101010000000110100000100110000011000010101001000010011100001000000001000110000011000010010
10001000101100001000011000000010000010100110001011100110011111101000000000110110000001000010100100100
00100010100110000111100010010100001000001000000010010001000000000000100001010000110110001101000100100
00011000011010000100100000001000000000000000000000001010000111100000010001100101100000001000100000001
10000101001110000011100100001000000000000001111100100010000000000110110000101000000000010000000000001
10000000001001100000010001010000001000101000000001100000001110111001100000001001001000001110001001000
01010010000010100000010000000111010001001001000010100110100001001000000100000010000001101010000000000
01000001000100001010000010010100000001010001100001101011001110000010111000110010101100000100101000000
10101000010011011001010100100000000000011010010110100010011000100111000000100010100010000000010000100
00001010000110000110001010000000100000000100100000001001001000000100100100001010000010110001001010000
10010010110100100000001000101000010000011000001000000000100010110000001001001101011000000011000011101
00110001100010000000110000110000000100010110000000000010010101010000101110011000001110101010010000000
11010010000000001000010110000111001100001000101000100000000010000000000101011010000000011000001000010
01110011101001011000000000000000010100101100010000100000111100011000000100101100010000100010010011100
01010011010110010000101101011001010001001000000001001000100001100000101001000100100110000011100100001
10101000000000100111011100000001000010111000010000010100101010000001000010000000100110010010110000000
00001000100110001001110101100100101000101100000000101010010011000001010001000000000000000000101000000
01001001011010100001000010101100000000000100000011010000100100010101010000100010000000010100001001100
11001000000001010010100010000110000000000000111011000000110100011001000000100010000000010000001010100
01000010010101000000000001011011100000100000000000000011000100000000111000101000010000000010010000000
10000101010110101100001101110101100100011111010110001000000100000000000101000000101000010101000100011
00010000000000001000010010000001101100100100000100110001001000000101111010000000100000111000000011010
00000010000011010101000101100110000000100001000010000000111010111010000001100010000110110000010000001
00001000000000101100000000100101011000010010001001000010000000000000010001000100110000001010010011010
01100101000100010000111010110000101011000000100010000100001000100000100000000111101000000000100000011
00000110100000000110100001000000001000100000110100000110111001101000000001000010001010001000000100010
01011000110000011000110001000011000101000000010001001000000010100011001011000011001100010011110000010
10000000010011100100000100100100001110100011000010001000010101010001110010100001001000000000011000010
00011100001101011001010000110100101000000000000011010101000011000100001010000000000111001000000000010
00010001110011010011110000110000000010001000010000001010000000001000110011000110100000000000000001000
00000000000000000010000000001100001010100000010001001000000000100000001000000010010000110100000010010
10001010000000101001001000000000010000000001000000101110000010010000001110000010000110000000001000000
01001001000111011000000100000000000000000010110000000100001000101100010111001000110000000100100110001
10000000000101011001000100101010101101010001010001010011111010000000001001011000010010010000000000000
01001000001011000100001110110001001010010010010010011101100011010000101000101000111000000010100010110
10010011000100001101100010000010100000100001000000001001000001110001001011011010000101011000110001000
00000010100000001100010000100000001010000000101100000000001000000000001000001000001001111110111000000
00001000000001001000000011010010100111001101001000101000010000010100010011111000000110001000110001010
00001010000001100000001001010100001000101001000100100101101100100011000001000001000100011100000111000
10000010001001101111010000111010000010100000110100010000110001110000000111011001011100100001001100000
10000001100000001001001011100111100101000010100000010010100101011011010101100111000110000000010001001
01000000000000111100100000000000010110100000011001000111000010000101101000000000000000111010110001101
01000100010000010101000001001001011000000001010000001000010100001110001100010000110010001000000010011
00010010010000000100010110000111011100000000001010000010001111111000010101010001000000000000110100101
10101000101111001000000000110010000010000010010001100001101000010101011000001001010000001000001100101
00100100100100000001000110100110010000111010000011000001101000000000100011000011100001011100000010100
00001000001000001011010110000001110001100000000001100001000000111100001010110000001010000100000100100
00001001100000001000101000000000001100011001101001000101101010000100111001000000001001010000100011001
00101110000110101000000100010001110001000010100100001100000000001001000101000010010010101000010001111
00000001001000101110100100100000001010001000100000000000000000010000001000000000000000010000000100000
01100000010001011001000000010011010000010011000001110000000000010101010001000001000000100110010000011
00000000010011101001000111010100001100001100001000000001000100000101101000010000101001011001010000000
01100000000010100110001001100011000110000001000011000010000000001000111000000111001011110101100100000
11100010000000001000000001100010100010001000001100100000100000000000111110001000000101100001000000000
00100000110100101110000010010001101000000001100101000010010001101001110000010010110110000100100010001
01000000101001000010001000000000000000000000000010110001011100000001000100101000110010000000100100100
11100001100010100000011110010100010100000010010010000100001011000000110000011111000100010100000000000
01000001010001000000110110011010000101000010000111100000000001010000001001010001011011001000000100011
10010000000010000000010101000011101000010101001001110101100110011100000010100000011010000010110110100
00000000100110000000000100000000001100000000101100010001110100100000000111010011000010000001100110000
00000110011001001010001000000001010000000010100010100000000000100000010011001011101000000010001000100
01000000000111011000000000101000000001000110110110010111111000000000110001000000000011000000000110001
01000001110110011010100110110101000110000010000000100000100100010010000000000000000000000010001000100
01100000100110010010101010001000000000010100110000001000000010100100010010001101001000001001101000110
11101011100001000000110000100011000001000111001010000100000001011000001000111000010000001101100100000
00000000110001001110100011010100100001010010010010010000110000000101001101000100000101011000000110101
00101001011100000000001011010000001000001010101010100100000000011101100010000000011010001000010001000
01000010100011101001011011000000101100011001000001010001010000100100010000000000000100111000101000000
00000010011000110100101000000000011110000100101100101110100100010000000010110001000110000010000001010
