10000011101010000100110000001010000101101000001001000001001111000100000111000010000110111000000001101
00000100100100100000001110011000000111010011010110000010011001000001000100011100101101110101101010000
00011101011000001000111000010000110010110000001010010000100000100011111010000011000000100000100001110
10001011000000000000010000000000101000101010010010101100000110000010010100011000100000010010100100010
10100000000111101100000000000000100100000011000010000100101010000001001010000000001010000000000000101
00000000100010011000100100100000100010001001111000111000010001100100000010010110001000000000010001010
00100000100000001011111101100101000101100001001100000110100000001000001111010100011010000110100011000
11000111100100000010000000001011001010001110100000100110110001000100001010110000001000000001001101001
00100110000000001001010011100001000000010000011000010000010100001000000000000000000010010010001001010
00100010010000000001001110000011000010100111001010001000011010001011000101000010011010110000001101000
00000000000100010100101001010101000010101011000111001010000000110001100000000010010000001001000000000
00100101110000011000000110001000000101000000111001011100000100000100000000100010000100000001100000011
01010000000010100100100001000010001100000110001001000000000010010101000110001011000011100000000000100
00010100001000000100110001010100000111001000010000000001110110100101011111010101101000000000001000001
10010100000000010100000100100100000000000000000010001010000000101000000100010101011000000000000000001
00100000101100010110010101000011101011100000010010100000001100010010100010000000111101101010000110000
01010001100101000001000101000110000000000000100000111010010011000011101000000001001011100100010000001
01000100000000001100010001100000100000100010100000000000101000000000100000010000100001001000001000000
00101010001010001000000110000011110111110001010100000101000010001000010010100001101001101010100000001
00000011010011000000010010000111011011000100101001000100011111010100000010000100010011011000101000101
00000000010000110010001010001000100000000101001100111101001000000000000100001111100101110000101100101
01000111000000100100000110010011000011000100000000010100000100011001010000000000000110000100000000100
00000000000101010000001000011000000000010111110001000100100001000100010000000000100000101001001000000
10000000000100110100110000010110000000000100000010100100110101010000100000000000000101000010001100100
00000000100101100011010111100001000101110010000000001011000010000001001010000000000011001010000000011
10001010011010001001000000001000010010010100101011001000010000010100000101010101101100000100000100000
00000001000000010110000001011011011100010110000001000101000010010000000001010000001100010001000001001
00000101001000000100000001010001001101010000001010110000000000000000100000010000011000100001010000010
11000000000100000000000000001101110011100001110000100000111100001000000000000001101100000110011001010
10100001010000100011101010000010001000000000000100101000000101100100000010001010100111001000000010000
00000010100000000001010000000100010100010100000100000000101000111000000100100011001011011000001100100
01000000111001000110010101100010110011000001001000100000011100110000001011000111100110101110000000111
00001110011001100000000100010000001001000000100111000100010001000000000000011001001111000001001010011
00000100100000100010001001001110010000101101000100010001010011000010100000110100000100011110011011010
10000100000000001000001000000100101000010000011000000100001000000100010000001000001100111011000000000
00001000100011011000100001000000100001000001000010001100000101100100000010000100000100000000100010111
00000000000010100000101000001000010000100001100001100101101000101010000000000010000001010000001010010
10000100000100000000010010000111100000011001000000000100011100100001000000100000100000100010011010000
00000010000000110100110001011010000010010100110001111101101110000001110010110101001011110001000010010
00000001000110010000000001000100101001000000000010100000000011100011001100010000010000100000100000011
00000000001000000001000110110000111000100011110000000000100000001000011010000001010100000000100101111
10010000001000101111001100000010010000000100100010100111000100000100100100000010001000010010110000000
11101101010010000010001000000010001010010110100101000000110000010010000000001111001010110000000101000
00001000000010000100000000110000010000000000000010001010000010111110001100010000110000000000000110000
00010000101100100110110001000000000000000101000000001101001001010000110110011000001110010001010000000
01001000000100100000010001001000101000000000000000001010001110100110011000101001111000000100101000011
00110001110000000010000100000101101101000000010001110001100011010011010010000011001000001100010100000
00000010000000000000100011000000000110010000101100010100000000000001000000100000010010000101000100111
10000000000000000010001000101100010010001001101011000010100101010110000000101001010100001100011100011
00101000000010000010100000000000001000000001100001000001110000000000110100110100010010110110100100100
01000110110111000111100011011100100000110101000000000100100100100100000000000100100000000000110001000
00100011111001101100011100000101100010000000101001110000000010000010100101100010001001001000100011100
10000000000000000010000000000000110001010010111100100011010010011010000101001100110000100101010000000
00100010000000000001100001111000000000100010101010010110011100100000010000001001000100000010000000001
10010001000101011000000001110100000000000100000010000000001110011011010111001100010101011010000001010
11000000001110000100010100000010000100101111001001011011010110010000000001110001010000011010000010100
00000010001110001000100101000010001101000001100010000010010001000001110000010001001001010000100100000
00000111100000101000010010101011100010100000001000001100100100110010000000101000000011010000011100011
01101101100101010000010110000101101000101100001001000011100100110000000000100000100011001000000000100
10100001000010100000000000010111011000000001100101000000110100110101010101010010000000100000010010100
01001100010000001110101010100000010000100000011000010001000000011000011010101100110101000011000001010
10000110000000000100111000110101000000000001110011100010001000000000010100011000000000000011000000000
01100001000000001010000100000000011001100100000000011000001100000000010000000000010010001101111000000
00100001010100010100000000000101001010100000000000100000100100000010001000000100100100001101000000111
00010011000111000000000111001001010000011100001110100010010000000100011000001100000010000111110100110
00010001000001000010010110000100001000000100010010101100001010000100100000001000000010000101010001000
00010000000100010010011010010101000100000000100001110101001000101000010000000010001101010001010010000
10001100010011000000100000000100100111000000101001001000010011010010100000001001100010000010011010001
10010000000010010011000011000000100001100000010000001001000110010000010010100010000000000100010000011
00010101100100101000111100000001010100100011000101001001001010101110010011001001010110001100000000000
00100101000010000110011001000100001010010000001000000001100000000000111110010011000100101011010011000
01000000010101000000000110000010110100100000000100000000000000011000000100000000100100010110011000001
00000000001100001000000000000000001010010001000011000001010000010000000100111011010100100000110100000
01100010100000100010010110001010010101110000000000010001000110000001100100100100010110010000110001100
00000000000001100111000101001100100000000000001010000000010000010000011101100011100110100100001000000
10000000110000100100001000010001100000001000111000011001111100010010011000001110100010010100100000010
10000000111001000000010000001000010011110000110000001100000000000001000101010000011000100110100000000
10100001100000010110001000100000001010000010010100000000010001100001000010101110000010000000000111100
00000110010011011100000000010000001100110000001101001010010010011010110101010100010001000110010110011
01101010110110110000010001000000100001000000000000000101000000001000000000000110010010010000010101101
01010000100000010010000000010000010001000001010000010000100000000011000001001000100001011100010001000
00010110000000000001101000000010000000000000100011011001000010110001100010010001010000001000101111001
01111000001010010111000001000100010010010001000011100001000000101101000110110100111001000000000101010
01101001001001001010111001000100110000000010000000000100000000111000000000010000110101010001010010110
10000010111001000010000010010000101000110001001000110000000010110000010100000000000100000000010000010
10011100000001010000011001110111101100001011000110011010010110001110010110000110000111000101101010001
10010001000000000111000100011001010101100000100000000010000000001010001100001110001000000110001101101
10101100000000010000001000000100001000000000000100100000010001100010011000000110110100111110000101101
00000000010010101000100010000110010000100001000000000100010101011000000010110010000010100000001010010
01100101110011010000000010000000011100011000000001101111010001001000000010010111000110100000001101010
00001000010100000100001011001100000110000110001000010000010010110110000100010010100100100000010001100
11001000011100110011000100101100110010001000000000101100000000000000101010101000001000010001010010010
00111000011001000001111011001001000000000100011001110101010001000000000100110101100100100011000100010
00001000000011000000000111101110000000000110010000100111010000000101000001011100000001010010001000010
10001001001101110000010100000010001010100001100000001001011110010000100010011001000001000001111000000
00100100000010000010101100000000100000001100011010010010100000010000000100000010001010000000000000001
10100000000100000010001101100001101010100110001011010001000011111100011000000001110011100000010010000
00001101100010001000001100100010000110000000000000101001101000000000100010011001001000001000110001101
00110000010000011001000010010110000001000011000011100100010000100100101101001000010000000001000110000
01100010000001010100000000000001000000100010011001100000001000010110100000000000001010011010100001010
10000100010101010011000111010001000101000100000100100000010000111110010100001100000001010000010110101
