10010101001000000110000000100111010000000000010000100100111010110000001000010101001001010011000000100
01000100000000100000100000000100000000000110000101000110110000001000000010011010001000001000001000110
01000000100110010001001001100001010010100000100000001100000000000001100000010000000000101100100000000
00101010100000001001000100000010000000100001000010000001000110000010001100111001110000010000010101100
01100000101000101010001100000010001101101001100000000000000000001100011000101000011001001111001000110
10100010101000011000001000100110101100111000111001000000010000000001010110000010000001000010000001110
01010000000000100011000010101101001100000100001101000000010101001001010010100000100000001101100100001
00000110100000001100010100110001001110000101001010001001000000100000100010000011110010000110011000000
10001000010000010111101101010101100010010001000111000100000100010100001100000001000010010000001010110
10101101111000010010000101000001100000001111110000001000110010001100010010100011010000011001011110101
00001101100000001010100111000000001000000001010100100100110000001110000110000000101100010000100001001
00001000111011100000011001001110100111100000000100010000000001000001000101000001000001011010010000010
10101001111000001001100100010000000010000011100101001000000000011000000000000011010010100111100110101
11000100011000001001100100101110000101100010110101010101000001000001100000000100000000001000000010111
01001111011110100000100111101100000000000100001001010000000001101110010010100000000000100101011110001
01011100010001000100100110110001000011100000000100110000100000110001100001010101000000000010000000011
11001010010000110001010000010011000000010100011000010010011001100111000000000100000000100010011010010
00000000001001100010001010000010000001001101000000110110000001101000011000000000100001000001100101111
00010100011000000000010010000111100101111100000100000001010000000000001101000101100000100001100010110
00010000000100011001000010011000101111000001000100001100010100111000000011000001000001000000111000000
00010000010000001001110100100010010000101000100000000000110000100010000100000000001111000110010000100
00100001011011110000010000010011000011001011001000000110001010110011010100100000001000101000001101010
01000001001000100001011010000000100000010100101000101100000001001110000101001010100001011001001000111
00000001000010000000001010000010000000000100100011101000100000001001010000000000000000000010101110000
00000000001100000010100000000000000001010001110000000000000000010000000100000001111010100100000000100
11000001000011110000000000110000011100000110011000111000100100110100110011001000010101101000000000011
01001010001001010001100110100000000010000000000000010000011001100000010000000000100011100000001010011
00000001010000000000000100010000010001101000010000000111110000101110000010000000110100100000011000111
11011000000001101001000000100010000000010000011001101100000000010001101000001010011001010001000100010
00111000010001010000110000010100000100000100001010010000001000010010110100001010000000000100110100100
01000001000100010000010000100011001000101010000000100001000001000000110000010010100001001000001000110
11001000010100101000011111100000100000000000101000000100000010100000101010000001000010001101100001010
01010010101000000001011100000010001000000001000001111110000111000010001000001001100110001000000000100
01110000000001011110000000011110101010101000001010000000110000101000000101001010011000000000000101000
10000100000000001000000000011101000000011000011100001000100000010001011000010100010000000011011000000
00010101010110000110000000001000000000000100100000110000000100101010000000010001000010100010111000100
01010000010000000010000110000010100000000000000000000100010111011010000111001000111000000100000000000
00110011000110001000010001000001000100000010101000000000101001001000000101010010100010010110000100011
00010000111010100111100100101001000001010011001101110000101000001000100000101000011000000000010010100
10100001011110000000000101000000000100010000000000000100000000000011100001100000010100010010100011000
01101111000011000001000010010000100000110000011011000001100000100011010010101100101010101000010001000
11000000010010000000000000001101010111111000011010011000000100000101000000100100100001001101000011010
00010001000000101000101101010100010001001010000101000010100000000110100000001000100110010001100110010
11100000100000010000010110000111110000001001000000100101100000010010000000000010011000000000001000000
00011010110010100011000000100011010000110010110000000001010000010001000001110001010100100000010000100
10000101101010110010000000000010001000000011110000000111101011011100000001000101110101100111101110010
01011000000001011100000000000000010000000110100000000001101100001010011100010000010001001011011000100
10000000001001101100110000000000100000001100100000110110010010000101000000100100000000001011000001000
00100000100010110110000100000100001000010000001010000010001001100101000000000101000100100100010000010
01000011000001100100010000100010010110001110000100010000011000001000001111000101000000001000000000001
11001000011000100010110000001001111000101101000111010100001010110100100000100001100100000000000110000
00100000000100010001000000001000001000000100100010010111010110100100000000000111010000100111001010000
11001000000011010001000010011000010000101110100100100001000110000100000000000010101011001100101111000
00101000000110010011000100100000010111000000100010010001010100101010000000000001011010000010100000000
00000000010001100000100100010110111001000010011110001100000010001001000100000000000000110000000011100
01010010001010100100100110000100010001000101100100101000010011000110000000000100010001000110010100010
10000101011100001000000010001000100101010100101101001100000100000110000000011000000000011100100000000
01001000001001100001011101010010001001100010110000010011001000111001001100010000001010010000000000001
00001001001010000100000000001001000001001100111010000000011101010011000010101010001100000011001111010
00001110000010000100000100101001011011100000000011001001010000000000111010000010110000100101010001000
00000001000011001010010000100000010010010000010000000000000000010010000110101000000000101000000011100
00100100000100001010101000000000010110101000001000001111001010001000011000001000000001000000101011000
00011011000000000101000000000110001000000000000010101000001000101000010000000100000111000100000000101
10000001000001000000010010000100000000001100011001000010100000010010001010101111010001001001001010000
00100010100001100110100000010000010000000011010111010100000010001010000000001010001000000001101001010
00010010100000010100001000110100000001011001100000010000000001000100100000010110001001111100001001010
01000101010000010100100100100100111000001010010000110001000001011010100101001000110100000001000000100
01001100101101101000000000001000110001000111001000100100000000101101010101010010001001001100010110111
00000011110000000100010101101010100001001010000110100000000000010100000101100101001000000000000010010
01000110001010001000100100000000000100101100000101000001011110000000001001000010000110100010010000000
01001011100110000100000000000000010010000000001001011100101001000000110000110000011010001110100000110
01101010010000010110111000101010000000010011001110001001000001111100001000000001000010100000110110100
00000100000010000000000000110000001110010010000000001001010000000111010100100000100000000100111000100
00111010101000100001010000010111000001100100110101000000010000000100010000000111000001000000000000100
10000100000001000111011100000000110011000110000110000001010101111001001101001100000111001101010000100
01111001100101000010111010000010000000010011000100000000000101000010111010001001010000100000111000010
00100010000100010000001100010001000101000000000000100000000001100000001010010011001000100010000000000
10101000000000100000000010000001011010000001000000010010111000100100000010100000100001001010000010001
11101010100010000000000001010000111011000100100000111111101001000000010000110011001000101010010001100
00101000110011101000001100001011000000000100010000101100101001110010000000001000000111010001000000010
00000100000110001010010000010000101001000001100000000100011000110000010000000100001100101000010110010
01110001011011000100000001000000001000101100110010100010000001000010001010000010000000101011110010000
10100000000100001111000000000010000110000000100000100011001100101010011000010100110000001001001010101
01001001000011101001011000001000000100010000101000001101000010000100110000100000100100010101000000110
10110100010100001001100001111110100000110010010000000000000010110001011000101100011101000000111001000
00000001010010000010011101001000000000010001000000001100100010000100000001101110010010000000000000000
10000001001001001000001000000000011001010111111101011010101100001000110001100010111000011000001000000
00000000000100100011101110010111011110001001000000010000100000000010110001001000001101010101010001001
00000110111001000011000000000110000001001001101010000101000000000010000000001001100000000000111000100
00010100101010011100010000110100000000010101011111001110000101011010100000010100000101000110011000100
11001001000000100000010000001010010111000000111010000100000100100110110001010100100000010011100000011
00010000000010001000110011010100001010010011001110010000000111000010000000000010001000001000101010001
01000010010011011101001000010100001011101000010100110011100010000100001000101001000010010011000000101
00001100110100000001000010110001010110111010001111001000001100001000111010011001101011010001001000100
01010000000010000110010110010010010011000100001010011101100100010011000010001100010100110001010001100
00001011000000000101000000000100010010011011100101100000000001111001011000010010110001101010100100001
00100001100010101001011000100101000100011000010010000000111001000001000100000000100111001100000001010
01000100001010100000000010101000100001000010100000110001010000000101100000110000001100000000011001001
01000000000110000010001000000100100000011000010000000001001110000011000010000110100001011100010000000
01011001000000100000101011110100000110101001000011000100000101000001010000001011000000001100000011100
00010000001000000000010000000000010010001100011011111001010100010000101000000100000111010010011001100
