00000000000100100000100011001000001010000001100100000000010000011000100100000000010100110000010000100
10011100000010001000100000000100001000000010010001000000010100000010000000100011000000000001010000011
00100001100000100000001100110000000000101001000111101001100101000010100000001010100000000001100110000
00000000000001000001001000000010101000010100000111000100001000000010011000101000001001000100000101001
00010000001011101011100001101100101000100111010000001010010000011011010010000010010101010101000001000
00000100011001010010110010011101001011000000000000011000000000010011000001101010101000010100100001000
00101100010010010000110100100010110000000000100011000000000111100100110100001011011000001000001000100
00001011000011110001010000001011001100011001001000100000001100000101001010100000100010001101010000000
10000001100101011011001000110100000110101001111010010000000000010010000010101010110001001000011000000
00000011000110100011010000001000010000000101010010101010000101001000000000010101000101110100011101100
00011100001000000010000000110000101000000111001111010000100101000000000010110011100010101000011000010
10011000000010000000001000100100010100100000100010010000000101011000001101100000100110001110010110010
11000000000000010100011000011011100000010011100011100000110000100000000000110100010001000010101111001
11100110011000010000000000110110010000010000101100100000100001000101000100000001100011000010000001000
01001000000001011000000000100110000100000001100000100000100000000000100010010001001000000110100010011
11010000100000010000010000101000011000000011001001001000010000100000101001010110100001000000100000010
01001100100000110010001111010001101000010000001000001000010001100010001000010101000110010010011000000
00101101110100001100010110000000000000010000100001100110101000101000001000100001000100010001100010001
00001010000001001001000010110010001000000000010110000111010000000000001001100001101000010111000100000
01001000100000001000001101100111000000000011010010011000111010110100000000111000001110110000001100101
00110000000101000110010001000010001001010001010110001000000000101011000000010010010000000000000110000
01001001110010000111001110010010000000000100000000100010000101010110000101000011101000100000110100000
00010001101000010010010011011000110100010001010000010001000000101001010100000000100000000100000111000
11000100100100100010010100000010000000100001000010101100001001000000000000000100001010011011001000000
10000001000000010101001100000001010101010011011001101100000000000011010010000000100000001000100010001
01000110000000101011100010110001000000000010000001000001000100000010001110000010000110000000000010000
11000001010101001001111000001100110010111100000100000010000001110011000000000101000000111000011000011
00100100101100010000000101000010000010001000001110001000111001011000101110001000001000100001100100011
10000000001100000000110101111000000000001000001100001000000001001001000100010011000111001010011001000
01100100111000001010001000001100110001001010100100010100000000000000101000110000100011011101001110010
01011000000101100000001000011000100001001000010000000000100000101001010001101001100000000010110000001
01000000000000010000001101000011010000001001010010010000010000110000110110010010010000101000011101110
00000000000000000010101010001110000110000000011010101011000110100100010010010010000000001001010101100
10001011001000010100000000100100000010100100100101000101000001000001111001110001100000100100111000100
00001100100011010100110000110001110010001101010110000110000010100010000001010111000001010110000111000
10000000101100101000011000001110001010010000011001100110100000001000011000001000010110001010100110001
10101000000001001000001001101001110000110000010000101000001000000000101000100110100000110000010001100
00101010100000001000001000000001000010010000100110001001011110000000000100000110010000000111100000001
00010100010101010000000101100000000001000011011100101110000000101001000111010000110000011100001110000
00000001011001000011110001111010101000101010000000110000010000000010000010001000100000000000010000100
00100000000000100110100000010000000001101000000100111101000000100010001001000000010001000011000000110
00000001101000010000011110010100010110000100000000000001000110100000001001000100000110111010100000000
10010100000000000010100000010110001110001100101111001110011100000010100110000010010000010000000000101
01100001000000010000000001010000000001100000000010000110000011000101000011010010000100000100000110001
10010000000100000010000000101000110110101110101011100001011000110000010100000010001101000011000100001
01001001101000010000101001101001011000110010011000010011000000010111000111000100010011011010100001100
10111000010100010000000100010000010000000000001000100110110110000110001111000001000000001001010001100
01101100000000000001000100001000111111111100000000100010100000100110000000000111001100100110000010000
10110010000111000010100010000101000001110010100000101101101000000010000100100001000001100111010110101
10000011001100000000000111000001110110010001011111000001101100100001100000111011000000011001000100000
00110011000010001100100000011101010100110000000001010000000000010000010100100011000001101000100110010
00110000000100010011000010100110011000001001100000000100000010110001001000000010000000100101010000000
10010000000000010101000000001011011001000111001000000101000101000100100011000011101100001100100011110
00000010010101010100000000000010100001100100010001001101100000110000000001010000000010111000100100001
10110010100110000000111000101000000100000110000100000001010000100110000000101010010010101110001000001
00000001000010100100101011000010100010000010100101000110001000111000000000101100000001010001100010001
10000100001000000110100101000010000011000000010100100010000000000100001001001111010110000000000100010
11010000010101000000101000010000001001000110001010001110101110010101010001000001100100100001111100100
00000000000000010000001101001010000000100110000011100010010110010110110111110100000000000001100000000
11000000000000000101000100110011010001110001001010010010110111000001100111011100101000000101010010100
10000000000100001000100001001101010010000000000000100000001100000000010100000010110000011000011000000
11001000001010000101000110110010100010101010001110110110010001110001001000010001100101111011100111011
11100011000100000000000100111000100000000000000000010011001001110000000010000010001110001100101000000
00100001000011011010001101011000101001000010100000000001000010000000000011110101000100001000000010001
11000010101001110000001000001000001000101011101000000011101111001011001101000000000010100000100000000
01000000111101110001100010110100000000000011100000001101001100001001110001001101000011000010001000000
00000001000001110001100000010000010100101100001101000001000010001000100000000001000001001001010101100
10000101001000101100000110100000000011111000000000010001000100001000111001000010000011010000100101001
00101001100000101011000000010010000001100001001001000000000000110001010100000100011000000111000001001
10100000000000001111000100011010100000010100000110101110100101000000001011000000000110000010001001101
10011000100000100000000000100111000100011010000100000000000101100100100001001101011111001000000100101
00000000000011100000110001100001000100100000011000100110001100000010000010010000000000000000000100001
11000101000100010000000001000100001100011100000010100101010011010000010110111000001011010001000011000
00001110011110000100000001010011010000011100100001010110100100000000000000001100100010011000000000010
00000100010011010110000110010010100100110000001000000100010101111100001000100101000010000100001000010
10100110001000110000000001011000110110000000010101010100000101110001000010010000010010101001001000000
00100100101100100001000011100000011111000010101000000000010111000010000001101101000000010000001011011
00110100000000100000010100000000011110100000001100100100001000001110010010101101001100000000001101100
10000001000000100100010101100110010010101000011100101001000010001000010011000101000000100000101000010
11010010100000010101100011100000010000001100000100000000000101010010100000000010111000000000001001110
01101001001000110010011000100000000001011100000000001011000010001000000100000100110010001100110001000
00001100000000100000001011000001000000010011100100001001001100101011111001011011011011000000001110010
00100100000111010000101110001001000000001000000000011100001011011000010110110100000110011011001100000
10010110000100001001101010100010001001111101001000000000000001010000100010000100110010100001001010101
00100000001010010100000010001000000010000010001000110001100100010000100010000010110000100000010000111
00100000000010010011010011100011000010000011000001011000111010011100000000000000011001001111000000110
10010000000000010110000000000001000000101100000000001101001111000010010101000100010000100001101000101
00000010110000011000100001000010001000000000011010000010101100110010001001010101001100001000000100000
00010010010100110100000100010001000100001100100001000100100101000000000010000000000001001010000000000
01011001010110100000010100000100000100000111001010000000001000100000001010000000001001000000001101000
10100100010100001010011000010101110100100001100000000100000000001100011011010001001100000000000101100
00000101001101001001001001110001011000000000110100001000011100000000110010011100100000001100001010010
00000000010000110000010010000010000000001111000000000000101000001010101011100000010011001100000001000
00011100110010000011110110011110000000000000001000000010100100011100101000100001000010010000000100101
01100000101001011010101010000000000010001000010001010001000010101000001000000001000100101010100010001
00000110000000000101000000010000001110011000100100010000000011001000000001110100000100010101000000010
00010100110000001000100000000001100000010001000000110101010100000000000000010000100000100010100000100
00100010000000111100000010101000101010100000000001010000000000010111101000111010000100100010101001011
00100000010000100010000000000100001000000110100001110100110100000000000110110011001100011000001000011
01100000001000000100010110111000000000001000011101000010100001100000000100010001000000000101101010100
00010000011100011111110110000100001010000000011000000010100010000000010000011110100110101000010010000
