11000010001011000001011110000001001000010000001101011000101000000100110101000010000100000100001010100
11100100010010010001100100000101000111001000001000000000000010111101011000000111000010011000100100100
01000000101000000000000001100001000010001111000000001011000000011010100000111000001000010000001000110
01001000000100110100110000001000001000000000001000010100000011010000011000000000000100100001001100001
00000101001000001000001010000101000001000000010001101011110011000000000000110001000110000000001000000
01011001001001101100000100111000010000000100001111010011100111000011011111000000000010000001011010100
11000000010011000001010000001000000100001111000000000000000100011011000000000010000110000010001000110
00100011010000010000010000000110111100001010001100001100000011100001000100101100100110100000010000010
01011101101001000000000101000011000000000100001111001101011000111000100000100001000001100000000111010
11001101101001100110000000001001000100011101010000100000000000001010010110110100011110100000001000100
00001001010000001000000011100000000010000011100000111000101010001100000000011010110010000001001100011
00000000001010110100011000010011000000100000000010010010001000010000000110000000001000000001000000010
01100100000001000000101100111001000000011010101010000000100010010000100000011100100001010000011101001
00000000001110000001010101000101110000010001010000011100000001000010001000110000000100000010000010010
11100000000110011011000110010001000000100000100000101000000010001001010000001010000110100010000001000
00001000000100000010001110011001001001000010110111000000100000011010000001010010001000000000000000111
01000001001000001000010110001101010101110011101100110000110101001101100101000010011000001110000100000
00101000000000000001110011100110110101100000000101100001010001100100101110110000000100000000000110001
10110010000000100010100100000001000000001010100100000001111000100101110010100100100000100000100100001
00000011101000001100011000000100001010010000000001010000010100101011010001101000000101000010010000000
11000101100010010000100000000101000000000010001100010101100110000000011100010000010100000000100000000
01010111000100000001110101101001000010001110100100000010000111100101100010000100000010100010100100000
11010010010000000010101100001000010000101000000000001001100001000110000000000111010001100000000001010
11000000000000100110000010100000000010100000000100100110001110101000101000101000000000010000011111110
00000000101011101100101000010000001000100000110000010001001101000000000010000001000101110001000000101
00001100111101010100000011000100101100001000000001010100000010001000000000000100011000010000100000001
00000000000000001011000100000000100000001000001000000100010000000010010000101101000000000010101000000
01110010010100001100110001100100010010100000001000000000001100000101010000100010000100000001011010001
01000110100001000010000001011000000101100010010010110010100010100000101100000010000000000011110011000
01001000001000101100110000010000110100011010111001100011000000001001110001000010000000010001010000100
00000010001010101001010001000100010010000100000010000101001000000001000000100011100010001000101010001
10000110010010001100101000001000100000111000001000000001000010000011101000010000000100010000000000100
00000001001000010000000111001001001001000100000101000000010000110100001110000010101000000000001100100
00000110010000011000010001100000101101101011100000000000011010000000001000100100110000000100100000000
00010010001001011110100100100000000100100001001001000001101001111101010100011010000011010110001010000
00000000110000110010000000010000111000010000011000100000011100010000011001000010000100100010001000010
10000000000010000000000111001010110100000111111000100001101000001000000110001000100001101000100000000
11000101010000000110000010010011001100000000000000000101000011000010011000000010000010000000011010001
11010101000101001000001010001110101000000000000100000000101000000011000101010110000100111000100000011
00010001100000000010000101000100000100100011001011110100010100110000100001010000000001000000001011000
01000010000001001110000010000110111000010010000000000000010000100010000000000000000001010010111000011
01001010000000000100100100111000100100101110010010001101000000010000000101001110100101001010101110101
00000011001100100000001010001000011101000100000010001010001110000001000000000001010100100100000100000
10000001010101010000011100001010001001000000000101001000000000101100111100100100100000101001000010001
00001000000001100100101000100100111010010001000011110000000000001001100000001100011000000011000100000
01110100100011110100100001100111000000111000000000000100000000101010100000010000010000000101000001001
01100101100011000100111001001001000010100110000000000100000000001010000001010100100010001001010000000
10010111101110000110100110001000010100101001110100110000011100101110000111110001000101101000000110100
10000100001100000100000010011010010010010000100000010110001100000000101000000000100001001001010000010
00010110001100101000000100000011000001001000010000010000010000000111101000010100000010100010000100100
00110001000100000000000100010111101011101010010010101011010010001000001100010000101011110010000001000
10110100010110000001000010010001000100000000000110000011100100100100001101011000011001000000000110001
01100000011000000000111000100001100010000001010110000000000100111010000011101011000000001010010000010
00101000000100010100100000001000011001000101001011010001000100010001001000001010000000001000101100100
11100000101001000010000000000000001100111101000000100010010000000101001001100000001110010010001010000
11001001001100010000101000000000100011000000100110000100011100000010000010000100011000000001001100000
10000000010111001011001001001101001010000100010110000101010000001111001100010010010110010100000010010
00010010101100010000000000000100000010010000000101000010000100011100100111000000100110000000100100001
10001000010000110000100000001000111011110000000011001000100101011010110010000000000100100100101101100
01100001100000000100000110000000100111100010101010110001100101000010001001000001101000001111001001000
00100000001000001110100010001100000000010000000011010111000000100100001001100000001011100000000101000
00000000000001101100011010001000000001010100010100001001010110000000001000000000001000010010001010000
01010000111010001100000010100000001100000001000110001010100000000100010100010000011100111100000100000
01100111101000000010011001000010010100000100011000001100001000100101001001000101000000000010001111100
00000110000001001001001000001000000101000000011001000000000111011100010001000000000000010100000001100
00000011000000010000000000100000100010000000000011001100010100000010000001110001100010010111000110100
01010011100010001001011010000101100001000000100010100011110110000000001001110000000101000010001100010
00100100100010110000001000100000010000000000000010010000010110101000100000001000010001000001000000000
01100000000101001010110100111010001010100001001000001000000011011010000000000001000010000010000000010
00100000010100000100100011110101000000100000101010100011100100001100010010100011001111100011011111000
01010101000011011001001100001010000110010000000011100010000101001000000100000100000000010010010000000
10001001110000010110010000000100000000000001101000100100001100000101000000011100000001100001001010000
10001000010000001110001010110001011100000100000000001101000000000000000000000001000001010000000000100
00000011000100001000001010010010001000000011001100010000010000010000000100001001010000100001000100100
01101100010001001010010010000100111000010001001010001000110000001000000100111001000000110001110000000
00100011001000001011000100010111100000110011100010101000000110000100011010010000000000110000100101101
00010100101001010000010000101100100000001000110000001000001010100100111000000010011000100010111100000
10100000011001100000000000000001100001010000011001000000000001000100000000101100010001000001001011010
00000000001001110001101000000000001100110001000000001000100000010011100100111000010110110000010111100
00100000000100010100000001000000000110010000000000100000010000000100100000010010110000001110000000010
01111000000000000101001001100110110000110001010001000110000000000000100100000010010100000000010000000
01000000000101000101010001010001111001011000101001000000000001001010100010001000001101001111001000000
00000100000000011001000110100100010000010000110000010000100000001010010010000110000011000010000000110
00000000100110001001001000000011011010000010101010100001000000110101000000100000110000000000100000000
00000101100101010110000000101100000010110000000001000010000000010000000110110010000000101001111000001
10000101011110100110000000000000001001000000001000000010101100001000101101001000010001010111000010001
01000001000100000010010110100000011000001000000000010100101100010000000001100010000011110100000111101
01000011000101100001000101000101101000001100010010010111000110000000000110001001100000000011001001000
00000001110001000100000010010100000001011000011000000011001000010000000001010001110100111000100000000
01010110001110110001000001101110000001101100001000100001001100000000010001000000101010101000001001000
01000000100010000001000001111000010001100000000011001101010011001011000100101000110000100100001010100
11100000110100001000000010110000011001001100100110001010101100011000001100100010000000010000101000100
01101001100010000011101101011101000000010110001000010010000001010000101000000100100000010000110011000
01001000111000000010100110110100100011000010000001010010000000100000000010100000000010000010000011000
00000011000100100010101000100100000000000100100010000000000010100110010000000100000000001000000000010
00000011001000001000001100010001000000111011010000000110000000101000000010000000100010101000010010100
00101000111001110110100000110010000000000010011101111010000011000100110100100010010101000011001000001
00101110000101000101000100100000100001000010011100010000101000000000100010000100000010010011010000101
01111000000110000011000000010110000100100001100011010100010000001000000000000000000101011010000110001
00011000100100011000100010000001001100000010010011000100100010010111010001110010001011000011000100001
10001000000101110000000101100100000000010000100010001000000101001001000010111000000010011001010001000
