11001000000110001010101011110000000001000100000000000110101100101001010101001010011100000101010000000
01000000000100100000011100000100000001001001000101100000100110001000100001010000000010001111000000110
10110000101111101000010010011000000000000111000000001000000010000100001001010000000000001001000000000
00000000000010110110101001000100010000000100001000000011000001000010001000000011000100010011001000000
00000100011100010001000000011001100001000000100100001001100001001000010100001100100100000010000000001
00101001010101000010001001101000010011000101100000110000010010010010000010000001010110000100000001000
01000000110000100000110010000000100010000010000000000010010110000100100001010011100000100101000100001
00000110100010100001110010000001100000000100111100000000101000110100100001000110010101000000000000010
00100101000001010010001001001000010001101110101110000010111000000000001000001100110010000000000101000
01010011001100010001111000000001001100000000000000000010000000000000100100001010000010000000110100000
00001010000010000010000001100100000000100010011100000110010011000001001000000000010001000000000011000
11000000000000010010000000000100100101100001010001101111100101000010001111010010001010001000000011010
00101000110100100000000000000100011000001010110100000100001000010110000010110010100010000100001100000
00011100000101000000000000101000110111010100010000010110000110000110000001001110000001110001110001000
10000110010000111100100000010001100000000010100000110001011000100000010101001000110010001000000000010
10010100010100000001011001010000010010000000000010000001000001100000000000100001010000101001010100010
00001110000001101100000011010000000100100100000000001000100001010000000000111000100001000001100101100
00010001001000000000010000110001100000000100100100100000011101000000100100000010011000000001010000000
01000001001000011000000000011001110000000010100010010000111100001000100000001110100110011000000000100
00101010010000010000000010010010110001100001010000000000000100000100000010100101000000000000000011000
10000001100010011000010100101100000001000010100000010001110000000011110010110000011000010000000001100
01100010000001100100100011101100000000101011110000000000000000100000001110000010101000101100000010000
11100001111100100001000000011100011000010001000010100000101100000000001010000001000000000000001011010
00000110000010010000001010001000010000000000100100101010000100000010001001000101100000001100001010000
00000000000000100100000110011010101100110010000000100110010010000100100101000010001011011011000001100
00010000001100010110000001000000101000001110000000000000110001001010001110001000000000011101101100011
00101011100000100000000010000100000001100000001111111010100100011111000101010000100000010001100001110
00000000011000111000000000000010010100100001011000000100000000110111100000000000000111001110000101010
10100000100001010101110000000011101000000000111001111001001010010001010000100101011100000011000000000
01100000101100101100110100000000000101000001000010111110100011110000000100000000000100100000000000000
10011001000100000000000010101000000001100000000011111101000000000111100000000101010100001000001100011
00100010110000101000100000000001000101110000010110111010000100100011100010100001000000001010101000100
00000000000100011101100000110100000110100101001100000000000101000000100100100010011111100001110010001
00001011000000010110001100000010001100100010100000100011000000011110000001010110010000000000000000010
10101000100010110010010001000100001010010010011000100000000000010010100000110000000110110010000000110
00000011001010000100001000001101010010000100000110011000001111000111001000000000001010001110011000010
01000100000011100000000111101100010001000000011000100101100010000000000000011100100101100000000100001
01111010111100110101011001111101110000011011000100001000001100010000000000000111000010000100001000011
10000010001010001010001000100000010110000010001100000000011100100010001000000100001001000001001000000
00010000001010100111010110100110110000000000001001101000001011001000001101110001000110110000110110010
01101001111101010000111110100000000110100010110000100101000001000000000000000001010000001000000000000
00000111001000001100100001100010100001000101001100010000100010011001111010000100111100000000000000110
10010101011000000011010010101110001000010001000011010100100100000011000000000101101000100010100000000
00001010000000110000000001100000000000001100000001100000010000100100010010010000101100101001101000110
01000001000001100000100000000001100000001000000111000101000110100000100100000000000000000000010000000
11010000110010010000001100010000010010111000000000000110010000100000000000000111100000100001111101100
00100110010000000000010100000001100000111101010100001000001100001000110101011001000100010101000000011
00000010001011000111011000110000010000100110000000001001100010100000011011000000010110100010100000110
00001110110001000010000010000111001001001000000010000101010110101000011010100010010111000010011101110
10000110011010010000010001001000010001000111100100011100000000001011100010001001010000000000000000010
00001001000100000100010001000010001100101000110010111000010000111001001110000001100000000000000011100
11100000000010010000000100000000000001101010010000100110000010100000000000001001100010000000000001001
01001010000111011011000100000101010000000101011000000000000000011001000001000000100001000101100011011
10110000000010110010000000000010000000000010000011001000011000000110101101010100001010010110101111000
00001111000100000000001000100100000000001010000010100100001101110001010001100000000100100000000000001
00011011110000100110001000110000101001010101000110010000001000100001100000011111001000011001000000100
00011001000000000001010100000000010100000101000100011000100011010010010101101100100001000000010100101
00010001100000111100010000000000000000010000100111110100000000000101011100001000000010101000000100010
01001100011110010000000000000000001100101011100001010100010000000001010001000000101010001000000011001
00100010100001010101110000010000101001100101001110000000010011010000101000010001000000000000100000100
01000000000000010001000000010010000101100001100011010000000100110001000101001100001000100000011000101
00110101000000011000110110111100010001000100000001000111000100000111100101010010010000010000010001000
10100000010010011000010000010100011010000000000000000100001111000001101000111000010101000001000111001
11101100000110101011001100010100000011100000101100100100001000101010111001001101100000100000000001010
10100000101000001000100011000000010100010000100011001110110001110000100100100100100001000000000000110
00110100001010101001001011000101001100000101101010010000000101001100000000000100110101100001001100100
10000100011010000001101000100001100001010100011100000100101110100000001011101011000000111000010100010
00001010101011100001000000101110100000000111000000101000111110000100111101101000001000101011001000011
10100000000111001010110110001100000100110001010000001000000010110011101000000010001000000100001100000
01110101010100011001111010001110100100010100000010100000010001010001001000000000000011011000100100100
01100011010101001100110000100010010000000010101111010100001010010001000101001011100111111001011000000
01100001000000111011000000010110100001110010000001000100000000010100000100001100000000010000100000000
00001011100000000100101111001100001101100000000000110010111001000000010010101000000010000000010101100
00010000000010101011100000000011010000001110011101000011000000000111110110101010000100000000010101011
00000100010010010100001000000010000001000110100010011001000010110000000110101100110010000100000010100
00000000000010010101100001100000000100010000001001100100000010000000001010110000000000000000000001110
00110100110000000001100000001001000000000011100000000000100010001000100110000000010000000000001100000
01101000000110100000001100000100000100001010011000001010100000000101010011001101010100000010110001100
00100001000000100111000000001110010011000010001010001000010100000100001100000010001001000100001010101
11000001101000010110000000000100001011010001001000000010001001010000010000001010000110001000000010101
01000000000101011110110011010000011010000000010001100110001100001000001100000101001000000001010110001
00100000001001100010000100011011000010110011100110000010000011000000101000111110000010000110011010000
01011000000001000100100011011010000001000100100101000000000000000011010000000100011001001010000000000
00100000001100001100010000000101101001110001010000100111000100000000000010010000111010110111000001000
01000000000100100001000000101000000100000001000001100000001000110000010000001001110001000001100011001
00010000011000000000000000001000001000001010001100000000011010000000010000010001100100000110001000001
11001000001011011001000010000010100100110000001001000010001011110101001110000000010001111001110001010
10101101001000000101100010011101100001110110101011010100000101111000000000100101000110000110000011110
01110000100001010010010100110010100100001100000000001000100000111000110000110100101010000001000100010
10110010011000000001000100000100110000001010000001001000100110010100110010010100010000110001000000000
00101011100000000000100000000100010100111100010000101000011100011100000101001000000100001000000100001
10010000000000001001010000000001010101000100000000001000100100000000000001001001001011100000011100111
00000010101001000001000010001001001100001011001001001000001001100000000100000000000000100000000010001
00101010001100000101100000001100001000100000010001001001100000000001100001111000000110010000100000000
00000010000000011001100000010000100110000001011001000000011110010000010001000010000000110000101110000
01000010101000111010000010000001010000110000100001100000000000001001100000001001101001101000001011010
00010010010101000001101100010000000001110001000000100100000000000100010100010000100001000000110001100
00011000011101000101100100001001000001001001010000101010010000000010010101101000101101001111001110011
00001100100110011000000000000001011101100010000000001000010001000000000000010010000001011001010000110
01000000000000100100000100111010001100000000000110000100000010011001101100010000110010010000001100001
11010000101010000010100001010001011101000100010011000000100000000010000000101100100000000010110110100
