00000001000100100010100001000000110000001010001101101010000010011000001100010000000011100000100100000
10100000110001000010010000001010111001001000101011010010100010001010100101000011000010000000001000010
00101000111001010000000000000110000101100000000011110000001001110010000000101000000000000000001011000
00100001111110100001101000001100011100011000001010011100000010100010100010001000100000001000100000011
10000000101000110011000100100100000000000001000001000100000100000100000100000000000000000101000010000
01001101010111010000100011111110000010100101000001101011011010111001110100010011001100001000000001000
10010000100000000001011001000001000011010000010010000000010110000010000000101110000101000000000010100
00101011010000000000101100000100101000000000010001110000001001100001011000000010000110010110000000011
10001000000000011100100011001000000000000010000000000111110101101000000000101000011100100001100100001
01000010011000000000010000010100000010110010101110001000001100000100010011000000111001111001100001001
11101100010000100010011100000011010000000001100010101110100100000010000000001000110100000010111100010
00001010000000010100010001101001101011000001001111101100000110001001000010000000111110000000000100000
00001000110000100000001010001110000000100100101000000100000000101000000100101000010000001010000010101
00000110110010000010000000000100110010011100001110110011010001100100000001000010000101010011000101001
00000010000001000000001001110000010100000001100001000100101000010001110010000001010000000000000000010
00100011110010000001000101001000100010001101000101100001000010001010100000000100010101000101000001110
00001000011000000000100110000000100000010001100100000101000000000001111110010000000010010000001010000
10000000001100001000000000100100000010001001110100100101101000001010011000011110100000010010001010001
11010011010011000110100000010101010001010010001110000100101011100000000011000000010001001000000000100
10000111100010100010101000001101000000010110001000001010010001000000000110100110000001010011010000000
11000110000010001001001000100110010100000000000000010010110010000000010100001100111100110000000100000
10000000001001000010010000100101010100001001000101100000110101000000000001000000110000100001000001010
00000000000000100010100000000001001010011000110101000011101000110110100100100111100110000011001010001
00100001110100001001001010011010110000011001110010001100000000000111000000100101000101101000000000000
10000010001000001000100000110110001000010001000110010110000100001000110000000000011010001000000000000
01001100110001000000000000010000010111000000000100010000001100110010010010011000000001000000000000000
01000000100000000000000000010001000000100000000000000000110000000001001100110000111000110001011010010
01100000000000110100000000000000000100000000010110001110100101001001100001101000001000001001101000110
00010000011000100000000001100111101101101010010100000000001000000100010100001100001001110101010000010
10000010111001000010000011000001000000010000000001100100000101000000001000000000101010010000100011110
00100110100100010000100000000010000010001100100010110000001000010110010100111100001010000001101010101
11010000010000000011000001001010100000100110000000011010010100001000000001110000000101000001110001000
01110000110010111000010000000011111011000001110001011011000000010000000100001100000000000000011000100
00000000001001010000010010000011111011111011111000001010000100000000000110000000100100000100000000001
01000000000011010000000000011000000101000000010100100100100000000000010010000100010001000010101100000
10101011100100101001001101000100001000001001000011000110000000110010000010000100000000010101000001000
00001000001010100011101101110000000110000000100000011101000100000100011010111011000000110101000010101
00000011010111000001110101010110011101001000001001001001010000010000110001000010010101101100001000000
01100110000101001111111101011101001000101010001000000000001110000010000100000100000000001011100100100
00110111000000000011010001000100000010000000010100000000000010001001011001000000010010000001001000000
00001111001010001101000101000000010000110000000010010101010011100000000100001100010100110000000101000
00010000101000000110000100000000100010000001110000001000010100011100000001110000010101010000110001000
11010000000010100110001100011010000001001010010000000010000000011010011000110000001010100001100010001
10000000110000000000001110000010110101100101110010000000000111010101101001001000000101110000000001010
01110000001010100010100011001110100000010000110000100001000100000101100000000010001110000010100001001
00010000100100000011000000000100000000000000100000010110110010000001001010000000110010000000010010100
00010010010001100100000000000011000001100100000100011100100000010000100000000001100000011000100010011
00000010011100010100000100000010000000000011101110101000110001100101110000110011000010010111011000100
00011000010100000101100101000011100000000000100110110010010000000001000000001000111000000000100000101
01001110100100100010010001000111000001001000011000001011110010011000100100000100100101100111010011000
01011101011000000100000111000100000101010001000000101000011000001011101000000001000101001100011100101
10000001010101100001000100100011010000000010110100101000010000000010000001000010000010010010001000001
00111010010000101000010100010000000011111101001000100100100001001001010001000001000010101110000011001
11000100111000110000001011001001111100000001001000000000000000000101001110000101010001111000000010100
00111111100100001001100011011100100010010001101110010000010000010101110010000101111000000100011000000
01100010000000010101000011001010110110000001011001001101000011010110010010000000000000000000000000011
10100000010000000001001000100011000000000000010110110001100011010000100000001101100110000100010000100
00000000001010000001000011111111000101001110101000011001111100101000000000000000110001000010000010011
10001010000001000100010100110110000001100000100000000000000100000110000001010010001100000101000100010
00000011100010000000000001100101100110001101101001101000100001100000001011001110000110010100100101101
11001000010010010000001010000001100011000110000111000000000010000100100011001001001001000001100100000
01100100010000000000000000111000011000011100000001110000000100110000100001001000000000001000100001000
00000010010000001100100010010001110000001100000101000011000010011010000000000110100001001000000100001
10100000100000101010001000100000001000101001000101001000001000100001100100000110000100000001000010101
00100101110000011000000011000010011000111000101001000000100001111001110000001010011000001100000100000
01010100001001010000000000001101101010000010010110000100100010001101000001010011001001000000100101100
00100111010001110000010000010011101000100000100001100110101010000010110010010111100100110010000000100
10010100011100101001000000000000111100110000011011001100011100010010011000000001010000010101000000110
00010000000000000000100100001000001011010000101000000001000000001000000000000110000000000100000100001
01001100100011000000000010111110110000000000000110111000010110101100000010000000000010100000001000111
00000001100000100000000010110001000000000111010000011010000000100000110111011100100010001111001000100
00011010101000100101101000100010000010001011101010100010000101000110001010100000010000000000001000000
10000000101000001001000010000000011001010010000010000100100000001001111110001101000000011000110000010
00000000100001000000010110011010000101000010010110110001000001101000000010001000010001000010010001011
10101001100000010010001011001100001010001001101010010100000100001001000101101000010100100000010010001
10000010001101000100010001100000010010011000000000000100000100101000011000010110110000000000101010000
00100100111001100100010101001000101001000110000101000000011000000000000001100110010011000100001000111
01000001010011000010000101001000110001000010001111000000000001000000001011011100001110000000011001100
00001110000000000100000010110010010001100101001110000000000010000001100000010110101000001000011010000
00100001110000001110010110000100000100000011110010010100000010000011101010001100001001110011000011101
00011011000000000000100000000110110000010110100110100000111010000000010000010000011100100100101001001
01100100010010001100000000001100010001101010001010000001010001101000011000010110010010110000010001001
01000000010101010100100010000011001001000001010000000000101000011000101000000000000000010000110000011
00000001100100011000001011011010000010100001001011000000000100000100010010001010100001100000001110000
00000100001001110110010010000000010000000001101010000000011000000100110011100000011010001101110000000
10000001010101001000011000100100100011011000000000000110000110000001001001001000011000000000001100000
10011000000011000101010111000000000001010000000000001101101000100000001000010000100010000001001100000
00110110001000010000000100000010010100000010000000000001001101000100000001010100010010100100100100000
01110000111110000010000000000101100001000000100100000100001101011010001000000011001001110100100000100
10000011110100010110100000110110101010010000000000000101110101000001000000000000000100000000011000010
11000100000111100000100000011001000111001111101000000011000001101100010000111000000001011001000010010
01100001010000001011000001001000010001000000100101000010000100000100110000001110101011010000001001100
11001000101101100000010001001001001001000000110000000010000100010100110000000010001100100110011001001
00001000000001010011100101010001001000000100110100011001000001000000100000100100001000010100101000000
10010100100100100010000001000000101101100010000010010101000000101100001010100000010010001010000001100
10000000100000000000100000000000000101100000011100001010101001110000000001001001000001001010010001000
00000000000001001000101000010011100010000000001000100001100010011100010010000101101001000001100000001
01000100100111000100000011000001011010001011000100000000100011010011000111010101000010000101000001011
01101101111100000101100010110010110001000000010111101010000000111001001000100000000001000000010000101
00000000010100010000000001001010001010000010000000001100010100110010100001010010001010101000001001001
10000000000000101000000011100100000001100010110001000000010010100000010000000000000010010011000110111
