01100100001010000010100100000000100011111110100000110101111010010000010011110000100000010000000010000
00010001111101000000001000100001000010010010000000000111101000001101000001100111000001101000000101110
01110000001000110100010000100011110000000001101000110010010100010011110000110000101000100010000000000
01100000001001001010000011000001110011011100010010000010000000000000010000000100111001010000100010011
00000100000000100000001110000000000111010011000000010011011000010110011000010000011001001011100100000
00010000001000010100010001000000100110001010010000000000000000110000000000101100000010001001100001000
11000110000100000110001010010010000010101000000011011001110000010001010110000110001110001000111001100
00101101001001000100000110000001000001000000000000111010100101010101101000001000000100100110100000010
00110001010000010000110010000000010100100001000001100000000010000010010001011011000001001100001100100
00010100001010110001000000000001101000111001110001000011001011000110101000110000100000000010000100001
01010011011000011110000101100010010100100000010010110001000000000100101001101100001001001111110110110
10101100001010001010010000100000110000110100000010010010000100000010100000010000110100000000110010010
11000001001101001011010100011110001101001111000000000101010010000000100100000010110100110001110101000
00100000100000101000110000010010001011000100010001000100000100111000111110000000100011110000100100000
00000000111100100000001000000110000000101011001000001001010100001010010101100100110011000010100000001
00010100000000000100000000101100010000001001010010010000001000001000001110000000011110011111110001100
00100010001000001011000100110000010101001001010000000000100001011100010100100000000111111011101000000
00000000101100110000100100000000000010110011000000100010000000001000000000000000000000100000011010001
00000000000000000010001100110000100010000011111000000100001100001001100000001000101100011101000000110
00000101000000000010011000011000101000100011010011010000001100001100010001101010000101100000000011000
01010001000101100000110000000100100000000000001000000000001000100010000001000000011010000011000110100
00001110101001010101010000000101000001000000110000011001001000100001000010010011000110000100110000000
00001001110000100100101000101010000001001100011000000000000100011001010000011011000000001000000001000
01100000000000000110100000100001000000000011010100000100000000000000001001000010000000010010000000100
10000000000000010100100000001010000001000010010001111000011000000000010000000111000010010000000010110
10010010000000101000010100000101010000001111000000000000010101101011000110010101010110000110101110000
00000101010001000000001000000000000011100100010100100011000011000010010000110000000001001000010000100
00101010100100011010010000000010001111000010000000001010010000001010000101000010100100001101010001010
10001000001011110101010010100100000010010100000000001000000000000110000100001000000001001011110110110
10011010010010010100000100110000001011011001000101000010001000010100111000000001001110001001000000000
01010000000000000101010000000000011000100100001001010000100100000100000001000110000001100001100000101
00100000001000000000100000010100111010001110000001010100110000000110001000010000101101101100001110000
00000001001110100000000000010000001100100001000100100001001000101001101101101100001000000000000100000
00000010010111000010001100000001001000000000101010011000100000000000000000100100010001010001111000000
00100100100110001001000000100100000000000000011010100000000010100101000001000011110010101100000011010
01110010000001101111011000011000000000000100001000001001000001000010111010100100000100101110000000101
10000000011101000110010011001011001111101000000000001010000001010000111111010010000111010111010000000
00000000011000100101110101000011000100001010100011100000000001000110010000010101001110000001011000000
00011011000001100001101000000100011100000000100010100000000000001011000000001010111000000011010010010
10100000010000101111100100011001000000000010000110001101100100000100000000000100000010000000010110100
00000000110010000000000100000000001000010000100001010001000000010110000100000000001001110100000000001
01000100000101000101010010100000100010000100000100010000110001000010101001100000001110110001101111100
01000100101000010001010000001110001011000101011001010000010000000000101001110100010000110000000100001
01100000000011100011100001000111000000010000001111101010101000010000110001100000000000001111000110111
00110010011000010000001110101000100001011000000100010100100000001110000000001010010110000110010000100
01100000000010001100100000000100000000001101001010000001100000101110010110110000010000100011000000011
00110001010111000000000000011001000001100100011100000000111000000010010000000000010011101000000010000
00101110011101101101000010000001001000101000110001100111011100010000001100000101010001000101000011000
00001001000100010000100011000000000111000001001000010011101010000010010001000000000011001100001000100
01000110000001001101000000000100001100010110000001010001011001010000010110000000001010000001000100111
00001011010000000000100100111110100101010101010000010110101000010000010101100101110000011011110100000
01100000011110100001100000000010000010000101100001001100010011000000011001000100010101001000111000000
10100101000000000001110011001011001000000000000100010000110000110010000100010110000000001101100001100
10110011100000000111111101000101000100000000100011000001010001000100000000000000000101100000110010100
10000000010111000001001100001010110010001000000001100100100001010100000000011010000000001101010010010
10100000010100100001010010010000100000001000100001000000000010000100000000000010000011011000000100000
11101101001010000000001100000011010010000010000000100101010000001001011101000010000010100000011100110
00111010100010001010010000001110011011100100011010100001000000010100010010000101001100010100001100001
01010000000000000100000001010001000000001000000000011100000000001100100010001000000100000011010001001
01000100010000000000000000001100000100100101111000000101000101000010000010100010001101101100001000000
00001001000001011101001101000001010011010010001000000000101100011010000010010101001101000000011000011
00000000010100001000100110010000000100110010001011000100100001111101000010010111100010100010000011100
00011000010000100010010010010000111010001000011000011010000000100000000000001010001000001110001000110
01100000100000000111010100001001000000101111000000000100010100001010000100000000000111100010000000100
01101001010000010000100000000101001101000000000000110101011010110000100001000100100000010000000000100
01010000000111000000100001000011000100000001110001000000000000000010011011010000000101011000000000101
11001001001010100000010010101000100110010000101110000100010000000001011100100011101101110010001100101
00100000010001101001100000011101001001110001000110100001100011001101101101101000010001011000100000000
11000100101100000000001010000000000110000011000000000000000001010010011100000000001000100000100000000
00001100000100101011010000000000100000000000000000000010011000011010111000001101111000110010001010010
00100010101000100100001010001000011000110111000000000001000100000011001000001010000001001000000000001
01000100010000111100000100001100000001101000000000000001000000001100011000011000010001010111011000000
00000100100000000010000000000000110000001000001110010100100001000010111110010000000001001000000101110
01000001000100111000000011000100000011111100110011010000000000110000001001000000101100001000000101000
01000010000101001011111010000000011000100110010011001000010011000000110100111010001011011100100101110
01010110000001000000000000000010000100101010010000000000000100000000010001000001100010000010010110001
00000001001000011010000010100000101010000001010010000001110000111011000000000001001000000101011101010
01101000000101010100110000010010000100100100000000001000000000000000011101001000001000000000001000100
00101000011011100100000110100000000001010110001100101010000011110000100010010001111110000000001001010
10000101001000001000000001000100010100000100001000010001000111001000010001000000001000111101001000000
11000000100110101101100110101000111001100001011110010010011000010011111101000000010001010000011000000
10100010001101010001000011000001000011000010010110000100010001110010001100000000000000110001000100011
01100110000000011111010000001110000000000000000000000010011010010010010000001100100000011010000110100
00000010010010000000010100100101000010001001010100011010010000000000000010001100010011001110101001101
00000110001010011000101100110000000010001101000000011000101000010100100100100010010100011000000010010
00000010100001100100000001000000101010100101000010100000001100100000001111010101000100001001001001000
00001000000100011001000000000001001010110101001011000000001000000100000010001000001000010001001100001
11001110000000101010100010000000010001000011010101000010001000010000101011000001010011001011010010010
10000001001001011010000010010000100010010000000001010001011000000100100110001010001000000000000101110
00101011010001000001001000001000101001010100011001100111010001101100001101000110000000000000001100100
00000001000110010001010000001100001000101101011000100100001000000000001010100111010000100000010100000
01111000010000011001000100001100100100100010000000001000010000001010000011100101000010000000100000000
00010100001100100101000000011010100010000000011000101000011100001010000100001001000000110000000000011
00010010000000011000010000000110000100000011000001000110010010000100100100101000001000010000000000000
01100100010100100000100000100110100010100000100001100000000011000000010000101011001000001011000001101
00100100010000010011111000001011100001001010000011001000000001000100011000100110100000001101010111100
00111010110001001001100010100000100101110000001011100100010001010101010100000100010010001011010110000
00001000111000100101100000011111001010000100001001001000111000000010101100000001100000000110010010011
10000100010100000110100101000000001000100000000110000010000000011100011001000100000100000000010001010
00001110110000010100000001000000010010010001000010000001000000001010001011100000001001011000011110110
01100000010000000000000000100101010001100010000010000101000011010000101100101000010001100100110010000
