10001110000000001100001100110011001010010000011000100000100000100010000001000011001000000000000001000
00000000101000010000000101000000000010000000100000101101000001011110001000010101000001011000000101000
00100010000010010101100001100111011000110110010111000000101010001011101111001010001010000001000000010
00000000110100110000001000000000101100110100000100000100000011110000001110000000011101100000001100000
10010110000000110010000000000110000001000001010100000110000011000010101001001011010000000010101001110
00000000100100000010110100011111000100110000101010010000010100000001001010000011011011000001011010001
10010000100010100010010001000000100010000001100001010000000000000101000000001100101010110011100101000
00101010100100010001000000010010000010000001001000110000100000010000100110000000000100000000001000011
00000011000000010100010100000000111001010000000010100001000000000010000101110101010000000000011100100
00001011011000100001001010010100001010101011010001100000010000010110010101000000100010100010100000001
00101010010000010000000010011111001011100100100000000011001000001100011010011100010011000000011101000
01000100000010011000001001000100100001000101001011001110001000010000000110001001101010100101000000011
10010011100011001110101011000010010100000000011000000110010011000000000000010000010111010010000000100
00000010100001000110101000000100101000010000000100001010001100001000110110000000000000000011000100011
11101101010010010011100101110101011010001100111000001011010010100100001100011000001100001101101010100
10001000000010010000100000111000110000101001110100100010000000001010010000101100111101001010000110000
00000110000001000100000001100010100110000011000001110011000001000101110000000000110000000000000000111
00100010000000001010000000000000000101110100001000000100001010000001000001000000000111000000001011010
11000100110101010001100000000111100001111010110110100001001010001000000010000011000100001000010010000
10010000000100010000000000000001100100110010000000100000000100000001000001001000001011001100101000000
00010100000100001000100100100010101000000010100101010100000010010101100101110001100000000000011000101
00011001000001011010011100000000010110111000100110001001010001110001000000000000111011000010010000011
10000100000100000000010000000000001001110000100000110010101000100000011011100010011101000000101010010
10111000110010110000010001011011000100000000011000001010011011001000000010000010000100001100000111001
00101000111010101110100001111010101000011111010001101010001000010010101010001101000001011000110000010
10100100001000000001000010011000000101101000101000100010000100001001000010000011100100000100000000010
10000010101101100110111111000000001101010000010010001010100100001000001001000000000000000111000000100
11010000110011010000000010010001000000010000000010011000011000001010100111100000000001100101100000000
01100001000010001011110000011110001110001010111000100001000000100001010101110110101110111000010100000
10000010110011000000010010001111010000010011010001010011010001001001011010110011100000010000000000100
00100000000110010000000000011001111101010000100000000000001010011000000100000001100001000000010000000
00001100001000000000010110000101000011001000000100000100000110000000110000000000001100100001101100010
10001110101000100101011100101010001001000000010000000011100001100100011000110000011011110001000000101
00110010000000110010010010101001101000100010011010100101011011011010000100010100000000000100010001001
00000100011100110110011000010001000011001010001000000000100110000100010010000000010000101000011010000
00000010000101000111001010001100100101101000100100000111110001000100010110101101000000100000100010011
00000010000000110001001000000000100100101110100000101000000111111100000000000100001110110001001000100
00000001101010001000010111010000001001000000111001001000011001100010100001001000000001011000110010000
11000000011010001000001010000000001101100100100011000010000000101010001010000000010000111011100000110
00100000000001110000110001010000101010100000000100000001100001101001001010100110010110001001101000000
00011011100010000010001001001000000101000100001000010000011100010010000011000000000110000011100000000
00010100001100001000001000101000000111100100001000111000001010101010011000111000001000000010000010010
11010100100010110101000000000010100110100100001001000000010000100101110001100110011110010010000001000
01000010000100100100000001001100011010000000001011000000000001100110001000100100111000001000000000100
10010101010000001000101111010100010000111000000100011001011110001000001000000000010000000100100000000
10001110010110000000000000100010010001010001010010000001010111010110001110100011101001100000000010000
00010101001000010010000000000100010001100111010011000110000110010101000000001001110000000100000000000
00101100010001010010001010000110111000000000101011100010101010000000000000000010000000101110000010000
10001001001011010011100001011000000001110110000111000110100110010000100000010110010010101101000000000
01000000100101010000011100000010100001010100000010100100010001010010010000110011000001000110001000010
11000001010001100000000001000000110100010010000001001100100000001010000000000101011001001100000000010
00000000000001000000000100000001000011010010010000010010000000010101000010110101111000110100010010000
01011000000000110001010100011000000001000010100001100000000010111101000000000000000010010110000001001
00000100001100001110000110010000100000110000010100100101101001000001000000010000101010111100100000000
00110000100100001000001000000001000100000000100000100010110000000001100001000001000110010010000001000
10110110010001000000010010001000011000111000001110000010000000011000000110010011010001010010100101000
00000000000111000010100111101001000110110010011000010000001000100001000000000001100010000001001000100
01000011010100010100001000110000011001000000000100101101100000101010001001000010100000101000000000100
00110010010110010110000101100000001000000110100001110000010001000110000100010001110000010000000001000
01010000000010101010010100010000010000010100000100001001001000110000010001100000000100010001001101001
00000000110000001101001011000000011000010010101001000110000001100000011101100100000001100001110111010
10000110110000010001010001010000000100010000000000110100001000100110000101001000100110011101000000100
00000010010111010000000010011100010011100101000000000100001000110001000000010010110100000000000000000
10100010000000000000101111001000000000110110000011000100010000001101000100001000000010010000000000011
10110011110100000000000100010000010011000010010011001011000000000100010000110001000000000100000000000
00010010000001010000110000110000100100001010111010100000001010110011111100000010100000010010100000000
01100000000011010000000100001010001001101010100011000000111000110111000000101010011000000100000000000
10000000001010000001010100000000010001011100000000100000010000010000101101110000000000000110000000000
11001100110100110010010000000001010011000001000101010010100010110110100100100000000010000001101000100
11000100001110000000100000001001010110000100101000011011000001000000000000000000001100010000001100000
01000001011101000000011000010000000101010000010010000010010100100010000110001000100001010000101011100
00100101001001100100010001001010110110000000100000100001000100101000000001100010100000011000101001000
10100000100101000000100111011000100001010000011100001100001100101010100110000011011001011011101000000
10100110000000101000010010010111000011000100110110100010101001000011110000001000010000100000110101010
11011010110001000111010110100000100000110010001100000100001010010100000100110100000100000001010000100
10000010000000000110000011110001000111110100010000000000000001101010111000000100010000110000010101000
00011000000010101010010101000000001100010101000001010101000100000001100000110000001001000001001010100
00001001000100000100001011001000000001001101111000010001000000000001010000000010001010000010000101001
01100000001000100110000010000000000010000100001000001001000001100000000000001001000110011000000000100
00101000000001001000101110100000000000000001000100000100001000000111000001000001000000111101101001010
00000010110000000000010111100100001001010100010000111100100001000000000100010111001100010011000010000
00011001001000000010100100001000111111010001000000100011000000101000110010000001010001011001110001111
01000100001100101100000001111100110001000000100000010100010100110000000011010010110001100001010101010
01000110000110010001011000000101100101101001100000011010010000111000111000000010010000010001010110010
01000010101000000011100110100100100110000001110010000001000010000000100010110011010010000000000101000
10100000000110001001000000010101100100001010010100000000000000001111010001010000000100000000001000000
10010000000001100100100000010110011010101000000100001001011000100011000101000100100110000100101100110
01010101000100000010010100010001100001000101001001100001001010001010001100001100001110111000110010100
00001100010000000011001011010001001000010111000000100001101010011000100010110110001000010100001000011
10100100001100111010100000001010010111001010000010100110001000110100000000000000100000100100001000111
10010001000100101001010000000000010001000001001100001000001000000010010010000010000100000000000010100
11001100010001100000010001000111000111000000101000001011001000010001100000000001000000000010001100100
00001101000000010000100000010110001100001010100000010000000001100100101001100001000100100010000001000
00000000110100100001010000000000010011000000000100010100010101110110010000100110000000000000000010111
10000000010100001010000001000001001100000010000001001100000010100110000010001011001001101110001010110
00000101110011000000100100100000010000001110000000000000000001001000001001000010000000000001000001010
00000001100000001011010001111100001001000000000000000000100000000000001010010101000000100000000000000
00000001010010000001100000001100000101000000010000100000010000100011111000000001000001001011101000100
10000100100000000100110000000011000000101010001010011000010000010000010000000000000001101010101000101
00001101101110000000001001010101001001000010100100100010100100000001000000000100000010110101111100101
00000111000111000000000110000000100000000000010101000001000100010011000000010011000100000000000100000
