00000111000000100010101001000000000101010101011000000101110101111000001101100011100000100100100000100
10010101000000010001100111001100100001000000000111000000000110100001101100010010011101000010011001101
00100110101000010010000100100000001100010100010100100001101101110000011000000100101110010010000011000
00001000110000000000010110000000011010001000110100000110000001100110000010010000110000101011000001111
00100010000111000100000100100001010000000111001110000110000000000000100000100001000111001101001000110
01100010000001000000001010000000100010011001010001101000000000010000000010000001100110001000110100001
10001110101000001100000011000000010010000001010000000001111010011000010010111100100110011111100001100
10101010101000110000010000010110011011100010000000001010111001000100101000110000010000000010000010000
01000001100100000001010000100010000000001000001011011011000110010111000001000001010010110010000000111
00000000001110101000000000110001000000000010000100100100000010001000000000001101011110111100100001010
11100100000001001100100010010100100100100101000000000000001001001000100100100100000011000100001000000
00101100000010110011110100011000010000000011111100000100111000000001111101000000100110100110000110010
01111100010001000000001000011000000100010011000000010001100010100010000011100000001010000101001001110
10001101101001000100100011000110001101010001000000001100000001000100000101011010011000011000000100110
10010001001000101000011000010110001000000000100101001000001000000000000101000111000111001000100100100
00000001000100010101011010000000000010010001011000010001000101011000001110000001011000000110001010000
00001001010000000001001001001001000101001111001000000001010000101001001010100100010110100001010001000
10000111000010110010110100000100000000010000100000000000101100010010000100001001100100001000000000001
10001001101000010101001000000010100100100010110101100110110000000000001001010001110010011100100010001
10101100000001001000000101001010010010011001110001010011101001100000000110011100001000000000010001100
00010010010000010100110100000000010111000000000010000010100100000101100001010000101001100100010000010
00010100110100010011000110110010110001010001100000001110000010001010001010001000001001010000110000001
01100110000101001100100001100100000011010001000011000001000100000011010000010000010101110100000011000
10000100000010111011110001010001001100110001011110111000110011111000100111000000100000000011001100010
11100100100110100001010101000001100000101000010000010001010101000000100001001011000100011010100101111
00110000011110010101110001000001001000000001111100110000011000101010000100000000001000001011010000001
00011000001010000100100000001100001111001011100000001000001000110111000000110000100100000000111000000
11010001011000110010000000000001001100000111100000100001010010001110010000100001011010010110001101000
00111001010010001110101010000000001000001001010000101010110001001010000000000001000000101001000110000
00000001100000001001000011001000110001100001100001010101001101011011110000000110001001010110011011011
00001000010101000000010000010100000001000001110010000100000000000100001000100001100110001000000101010
10001000100011000011010000000001100010000000000011101010010100010111100000100100100000111000000001000
10001011111000000000101010100100000000001010000001011000101010001001011111011000010000011100000101100
10001010100000000101101001000001110010001100010000011010000100100001011000010100011000100001100000000
00001000100000000101011100000110100010000000010010000110101111010100100011001010010000000001100000100
00000100100010011001111000000100001101100011001000001000000010000000110001111010000000011100000000000
00111010100000101010100100000001001010001000000011000000010011001110000000010111100000001000000100000
00110011000111000101010000001011000010000000000000010000000101100010101000000001010010010000000000111
00001001000011010100000000000011000110000001011100110010100111000001010010111001000010000001010011000
00000000100001100000011000010001001000111000010000000000000000010000010000001100000010010011000010010
00001000000000000000100110000110100000000000100000000000000000100101000001010011000001100001000010111
01010111000000000001001001110011000000011110000001000001011000010111000101001001100000100000000001001
00011111010000100000000010101001010001100100001000100001100101000100000100000011010001011000000000011
11011011101000001001000111000111011000011000000000100000000100001001101000001000010100010010100001000
00000000010000000101000100111010000001001100000100110000010000100000000000100000000010001100100000000
10000000000111000010100110000000000001001110000010000100000100001000000001110000001000000010000010000
11101000000000000101001000011000000000000000000111010010010110001100000000011010000010110101011001000
10000000101011011000101011110100000100000100000000000000110000101000000001101010100110111000101000000
10010001001000100100001000001000000100010101000000001000001010000001000011000101001000100011010010001
00010000010010010100011011000101000010000000101101010101000010000000100000100111001001011000110010001
11010001001101000110110100010001000001101010100001100000011100011000100000010001100000000000101001100
00001000000111010001010001010001100000110111000001000110000010110110101110110000011000000000111100010
10110000010010000001001000010110001100000001000100000011010001101100101011000001100010101000001001100
00001000010010000000000000100010100000111001111000000011011101100000010001000101100000110000001000000
00010000000001010101101001011100000000010010101010001000011100111001100000101001000011100100000100111
01000000000000000101010011100010010010000100100001000000010000000001001000110010000001010110000110011
00000010010000000001011000010001001000010001101110101000100000000000000101000010100110001100101000010
00000000001010110001011101000000000010100111001011010100010100000011001100100111011001100111100110110
01101001000010001100101011000001001010011111000011000001010010101000000000000010001000101000010000001
01001000001101000000100001001101001000000100000110001000000100100000100001001010000001001000001010001
11001001011001100001000011011000001111100001000010000100010100000000101010010100000001110100000010001
00000100000000010000000001011011111010000101100001000000100001000000000010101001001100110001010001010
10100001110010011000010000001000001000011001000100000100111001101011000000111011100010011010010001110
10100001111100011001110000000000011100001000000100010010000001010110110100100000110100000000000010001
01100111001001101000000000000000000001010101001001010001110101010110001001010001111000000010000011000
00001000010010000010110011001001000000000011000100100000011001000110010110000001000001010001011010010
01000000010000101100100000000000000010111010011011010000100111010100001010110010100000001001000011110
01000000110010000010001100110000000001011001100000101011010011000101001000100101011100001110011000000
01010000001000000000110001110001110000011000101010010001000000110000001100010000000000000100101100100
00101110000000000000101110000000000110000000000000100000000101000011100111000111100010101100000100001
00010100101000000101000100100001100000100001100000000010010100010010000000000001000011000101010101001
01000000000010100100001100110110011000000000000000100000011000000001001001100010001000000010011010000
01001001000111101011100000110010001000000000001000011110100001101000000110100011100101000101000000101
00000100011010000011100000011000000000000000100000100000000100000101110010010001100000110001000100001
00000000000101010100010000000010001001000001010101001000000001010011000001000010001100000000100000001
00010000000000010011101001100001000000110111000000000101100000001000100010001010000000000000100000011
00000011100100100000000001111110100000010100001110001000010111000110000010010000101011000010011000100
00111100100101100010000100100000011100011001100100000110000010000000100000000110011000001100000001010
01101000000010110000000000000001100010001000001100000010001010110100011101000010100010000100000001100
00001000100100001010001100000001110000010000010010100000000001000010100101000000000101000001000010010
10000000001010000010100001110010000010011111100000000101000101110000111000100101000000000000100100011
01010001100001000100000000001010000000011000110000001001010001011000000000100000000100000000001001010
00000001100100010000001010100000000101010001100000100010010000000011000000110111100100010101010110000
00000011000000001001001001001000001000001001100000101001100110010000000000010101000010001000100000010
00001100000010100001110000110001100010110010000111000000001101001011101101100100111110010000000000010
00001000110010000000101000000000100100100010000000000011100010100001101000010000000111000010100000011
00001000110011000001000001000110101000000101000110001010100000111100110000000000000000001010000011001
01000101010010111001011100000001000110000010100000000000001100110000000010000001100001100010000100101
00010010000000001111100001010110000100010100000000000101000101000000010100100010110000010000011011101
00100000000000000000010100000000010100000010000000010011010000001010010001000111010000000100001001000
11011000001000010100110001110100000010000111000100010010000001010000110101100010000011111111000000000
00111010000010000100001001000010000000001011101101000010000110001010000000101110010001000001000000000
01000100100100000111000001000101101001010001000001010100000000101010100000001010000000000000111000000
00001000000010001101000010001001000010011100000111000110110101110000011100000000000000000000010100000
00101100100100000010000100000000001000100110110010000001000010010000000010000000011100010000000000010
10000000000100000010110001001010000000000000000000000011000010000000100100000101000011000100100011000
01000000101010000101000110000101011000100000000110000100001000000011000110000100100101101100001001000
00010010000010010000000000000001100001010010100000000000111010001010010010101100000010001011010000100
00001110000101000001001000000001010101010010101000000000001100000010100001000100000000010010001001100
11000011000010000100001001001010000010111010111100001110100110100000000000010110010001111010010000100
01010010000001100000000011100001101000101001000000000000001000010111001001000001001100000110100110100
