00110010010011001110011000001000010100010101101000000001000001100010000000000110001110100100000000100
00010001101001011100011001000000100001000010000101101000000100001111000011111001000000001000100100000
00100110000010011100010111101010000000000010001000011000010000101100101000010000101010000000110110110
00000100000000100010001111110001110000011001010100010010001000010011100010101000000001110001000110011
00101001000001110100100000000100000001001010000000000100000010100010000000000011101000000100010000010
10100001001101000000110001001100011010000000101000100100000101101100110010000001010100001000100010001
01100011100010110001000001111000101000111101100110010100001001001100000010000000001010111101000001010
01010010100001100001010000100010100001100110101100000010110000111010000000000110010001100100000100100
00000000100000101000001000011110011101101010000001001001010000010101010000011011000010000000110000000
11110001010110001000010000010100100001001111000000101000111000000000001001101101000010011000010010001
10000000011001011000111001000000100110011000000010000010011000000101100010100110000111000000100000001
11000100000000001000000000010000000100000100110000100000000011001100001100000101000100101000000001100
01000011010010110001000000001100100001001001100101010001100110001000001000001000000010001011110000000
00010000011010100010010000010000001000101000100000010000011001000000000101010100000101001100001000001
00001100001000010001001010000001000100010011110110000100000111001111000100000000000010011101000100101
01110110010011010100011101011000000000000100000001110101010101010011101100000011000011100000000101000
01000100011000011110010100000100000100100110000101000000000011110010000110101100010010001000000001000
11100011110001000011001011000011000000001111000110101010001101101101101010001010011110001000011000000
11010100001100000000010010000010000000000100011001011100000000000000101010010010000000001110000000111
10101100000000100000010000001000011001000010100100100000100000010001001000000000011000010100011000100
00001010110000000101000000000001100000001101000011110110000010001000111010000010000001000010010011000
00010011010110001000000011000000010000100000000010001000010110000100110101010110001110000000000000010
01000000001000010001100000001001010000000000100111011011100000000111000100000011011111011000000000000
10101000000010001100000100000011110000000110010010000001010001001010011000000010100010011100101100000
10000001000100001000001000100010000100011100111101000001100000100010000000001001001100110001000001000
01000001100010100000100100010001100000011110011000010000101111100110100110100001001101100001110100001
10010001000001000000001010001101100000000001001110001010110000000001101000101000000000100000000010000
00100010011101010101100000000000001000001101000001010101101100101001100110010010101110101100101000000
10100000001100011000101100000111101000001000000000011000000111000011000010000000000000000001010100110
01100000100001101000100100010000000000100000110000011000011011010001001010000101100101000011010000100
00010000010000000000110000001001100101000000110011000100000010010000101010000010111011001000000010110
00001100111010111000000011000110100111001101000010100100101010001000010110001001110100000001000000011
01001100010101011100000100000001101000010000100111000010100011000110000111000000001000011101100000010
00111001000100000100010000011010000100010110000000001010101100010110000010000001000011010000010001011
00100000011101010100101001000110100000011000010000100000010010100001011000000100110000111000010010011
00011000100011100111111101101111001110010010000010000110101101101000100010000000001001001000100100010
01010101111010000001000000100100101010000001001100011100000000000000000000010011100010100001110000010
00000101101011001110000100011001100001100001000001100001011001101001001000000100011111000001000001110
00000000000011100000110111010000000010000000101000011000000010010000100100000001010000000000101100100
10011000100101010011011011001001111001000010110010000001000000011101001010111011000000000000010000111
00100100001000000100110010010000010000000100011001100001000001010000010000011000011000000000001100000
00001000100000000010000001011000001000110000100010001010101100001011010000101000001001110001000100001
10000010001000010000110100010000011000100011110001100001101000000001010000000100010001001000000000010
01000000101001000010100010000001010000100100110000001100100011000000000000011000000010011001010010000
00100000000000001000010000000010010000000000100010101010000101000100010010001010010010100010000100000
01111000100001111000010101100000100101000000100100000100000000011000110011000000000110111100010100111
00100111000011010000000100000100000011000010100000110000100100100000010000011100100100000010001111000
01000000100100000010001111100011111110100010000000011001010101000000010000101000011110110101000010011
00010001000100000111101010010000010111000010010001001011001001100000000010001000001100010011010010001
01001001010001000010000110010000101001100001000001010000000100011000000001101000000000010000000001110
00011000000000001100000110000001100100000000000011100010110100001011010000000000100000000000000001010
00000000001100100101001000011100110010001000110110010010000000010000000100100001000101000000011100010
10110011010000100010101000000000000001001110010010000000001101001100001100010010100011001101001000111
00011000011010100110000011100110101000000000010000000110011101001000000001000001100010000000010110000
10011000000000000000110000001010001000001000000010110010000101100110001000010111000000101010001010000
01000000010111010001011000001100100000011000000010000100010101000110000001100010000100001000000100000
00000010101000010000010000010000110000001011011110000000010001000100010110010011011000010000000000000
00001100010111010000000011000100100101001000001000000100110000001110100000000011000011001101000000000
00100010001100010000010111000001111101001100000001010001000000100101010100000000000101110001110010010
00010100000010011100100001010100100101100010100110100000000000110110010000011100100011010000000001000
01010010101100000000111010100010000000000001000000110000000001010000000010000001001100010000100100000
10001010000110001000011010001111100111000010001010101000001000100010100001000100100100101000010000000
01001110000000101010000001010001100001010100011111000000100100110100001000100000110100010000000011010
00000100000001010000010000100000001001100000100011100011100000010000010000001100000100000100100100101
10010000100011000001101001000111000101101010100011000110001010011100010101100000100000100000001000001
00000101011101100010000011010000111100000001011000000010000000000011001000001010000000101000000000011
00000000101001110001100011000000110000000100001000110001001110000100011100000001110010000011100110000
00111100100010001000000110001000010010110000100100000000100101011010100010010010000001000000011100000
10001110000011011000100101001000000101000010111011001010000010000101000101000001001010100000110000001
00011010000110001000000100001000100001000110010000101100010001001000010000101000010110000000000101011
00100000000010001100001101100000001000000001000000111101000010100001100100010000101001100010000000000
10000000000000001000001000001000000010100001001001010011100110010001011010110000101110011111000000100
00001001001010010001010000000000100011000011100000000000000001000000011001010000110010000011101011101
01000010000000001011010010000000000100011001100000010100010100011001101000100100000101000000000110100
10101100101010000100100010101000101000010010101000100000011000101001000000010001011000000110000011000
11001001000010100000000100101100000011010110000011001010000100000010110110000001000000001010100010001
01111000010000001100001010001010100001010000011001101000101000011001000100001010101001111000110010010
00010000011010000000000011000100010001000000001101100000010010111010010000101100010000010010001110001
00000100010000100001000100000010000000001000000100000001000000100100110001100000110000011000010000001
11001000100100011000110011010000000000011110000010110000011110010000011000000000000001001000001000010
10010100001001010010100011010101010100000100001001011011000011000100000000000000000000000110110001000
00100000000000000000110100010001010001100100000110000000000010000010001010000000001011000000000000111
00001010100000000101000100101000001000000000000000000110100111010010001110000010101100000100000101001
01111001000001100010100001010000010000001100111100001101000110000001101010001000000001000010011001001
00000010010000000101000000000100100010000001000000100010100000000010100010010010100000100100001111000
00011000000000110010000101000000000011000010000110010000110001010000001100110000000110011010011000100
00100001011000011110011011100001100000000010010101000000011101111011100100000101001100000010011000000
11001000000010111000100000100000000101001000001000001100100000100001000000000110010101100000000010101
00001000111000000100001100000100100100000100000101101010011011100000110000000000100100001010100111000
01110000110000001000011100000111000001000101001011110000000001010111010010010001110011000001001000100
01000001001110101000000000000010100100010011000000010000101010011100101000100000011100001000000000000
11111101010100010011011011000000010100000100010111100000000100010000001000010110000000100001000011000
00100000100011001101011001011010000000011001000001000001000000100100010011000001110100001000000110100
00000000011000000000010000000010100000010000000000100010000000000001000001000011101011000001000010001
01101010101010000010001110000111001101100001000000001000000001101011001101010001110101001000100100010
00011110010110001010001010001000001000101000000000000110001000000010010000001000010101000000001110000
00010000010001010001011111010010000000011001000100000000011101100000100101100001000001000100101010100
00111001000110000001000000100010000000000110001000001111101010001100001010000001000001010000010000100
10001100000001100001001000100010100011010000110000000000001110111010101001010001100010111001000010000
10010011000100100000110110000000000000000010000101000000100000000101101001000000101010100100001001000
10001001001000011000000000000100010000001011011000001000110001000001000101010000000100110000001010001
