00000000001110011000000110000000010100000000010100010000011000001000010100100000001000110010100011001
01001000110000011000001000000000000101100110010001100010001000010001000100011101100000100000000000000
10101100011110000000000000011110000010000000001101000011000100000000001000010101000100000011101011000
01010000111000010001100110000101000000110000001000000111000011100001000000000100001000100001010100001
00010001000101000010000011111100110000111000000110110010100000000011110010000101000000101000000000000
00011001101001111001011000001000001101010011110000100101100010110100001111001000001110001000000000000
11001010000000000000000010111000010000000101000000001011000010001010011001010011000110100100000010000
10000100001000001010100010010010010000000101000100101011110110000001101110000111000100100010001000000
01000000000000100010010001100100000000000000010000010010000000100000110101000001001000100000110000010
00001001010001000000000000001110011111000001010110101000101111000000011010110000000000011000100000100
00000111000100111011000000110100010010000000000010000000000001011110000000000000000101000010101011100
00010100010100101101000101001100001000000000000010110010100100011100010100000000000110011001100010000
01101000101100000001100000011010000000101001010000100010011011100000011000001010000001010001100100000
01001011101000001010000011100110100000011000000100001010010100110100001000010001001001011010101000100
10000000001000011000001000111010011100011000000011001001011000100000110010011011000011010010010000110
00000010000000000010000010000100000001100000000110000000000010011011000101000000100101010011000110001
01100010001000001100000010000000001000000010010000101010000011000100010110000000010000000111001000101
00000000001100111100000011011001000010100000110011001010100000101000000010111011010010010010110101101
10000100000101000010101000101000100000100000010010000000100001000010010010010100111000001101010010000
00100001100001000000001000110011011110110001100010010001000000100100000010000011000000100101000000101
00000100101000110000001110110111101010000010000000000010000000001011110110000000100001011000010101001
00000010000000010100000000000010110000011100011000101000100000101111101000001000111000001010100001010
10000010000100001110010000010100001001110001000000101011100010100010001000000010001011111010001100001
00010001000101101001111100000100000000010000000001010000000000000000110101001000000001011100001000101
10001000001001111010101000101001101001010000001001001000000011000000000010100010000000000100010001010
10011010000010001100000000010100101001000000001000101100000100001000110001100000011011000000001000000
00010000000000000100000011000101001110000100000010101100000110110100000010110110100000100001001000000
01000000000001011100000011101010000001000010010000100000000110000001110011010110100000010001100000000
10001001110100010010000010001011011000111000010000010000100101011000000100011010000010000001100000101
00100001001000000110010100101011001101100001000011000010001000001001010010011000000001000000010100101
00101000110000111101100100100000000010101110101110100001001111000101100011101010001010010100010101000
00001101000100000001101100001010100001011010000000100100101010100101001000000011100100100011001010110
10110001111011010000000000000010010001000010000100010001100101011011010001010110010100100010000000000
11010010001000011010110000110000001001000100000101100000000000000000011001010000000101000001000000000
10110011000000111000011100010101000011000000000000100000010011111000011000000100000000011001011000100
10000100100100010010111100101110111101010011000100110000111101101000001100001100000000110001001111100
00101000101000100000110000000000001001010000100000110001000010100000010001011100010000101000110010011
00101000110010010011110000001000000000000100001001000101000000000110000110101110011000101000101111011
10100011101001001000010001000010001000000000100010101100000000000000101010100000011100100010100000010
00000100010000000000000001100000000000010100001000000100000010001000000011100000100110100010000000000
01000100001000000010101010100001000000010001001000000010000000000001010001000000100011001010111110010
10001000000111001100001100101000000010100010100001100100000001100101011100110101100100010000100101000
00010100100000000001000001001001000011001110000110000100101010010000000101000110100000000110001101100
11110011000010011010111001000010010010000100100001101110000010100111100010000010100000011010011111100
01000011100000000101000000000000001000000110100001101101001011101000010000000001100000000100000001001
01100011000000000000000001000100010010010101111100110000001111100110001101100010101001001001101011000
01100001000101100000110010100010001100000000100111000000100101100101010001110110000010000000000100000
00100001101100000000001110001011010101000010100110000010001010011000110000000001010010100011011011100
00000101000001001100000000100010000001001111101000000100010100101001100011000010101000010001001001000
00000010000010101110001000000010001000000001000001000000000011001000011100110001000101000001000001100
01000001100010001000101100010010000011011000000111101100010101001000001000101011010001011000001011000
10010101000001000111000100000000100000000010010001010000010000010010010010000001001010010010011001100
00110011000101010000000001000011000000000010001001100010100011000000110001010000000000000111100000101
00000111001110100000000000000000010001011100011110011011010000100001100000010100000000001110111100000
11000000010100000110100011101000100001100101100000000110000010010000100111001100111010010011001001000
01110110100000001000000000011010101010010011010010010100001010000001000000010001010100001010000011101
00000000000010001001100100110001110100001000011000000000000010001000000000010100000010001010000100000
10100110101110101100000101100101101000110111010111110100010001101000001000011000110111011101001000110
11100011101001001011111101010000100010101100001000000000100101110000000000100100100000100000001010000
01000001100010000100000000001000111011100011101000001010001001000111000100000011100000000100001000101
00100000010001001000010100000000000000001000000011001000001000000101110000001100001001001001000000000
01001011001010110000100100100100100010000000100000000000000000100011001001100000000000010101001101010
01100000010000100101000000001001010010000000000001100010010010110100000111011001000001111000001000000
10011001100100000001000100000100100000001011000000001010100110000000101010100000010100100011100100010
00111101010100100110000000001010010100100000001010010100100010001001101000000010000000010100000000100
00101001000000001000000110011110010000010100010001110100000010101000001110010010100000010001001110010
00010000001010111001110000101101010000110010010100000110011010001010010000000100100000001000110101000
11011100101010101100010110000001110000010001110000100100000001100000010101001101000010000000000011000
10001100000000000100001000100000000110000100010110001000000101001001000100100010011000000010000111001
00110010000001100101000100011000001010100001101111010101011100001000000000100000100110000010101001001
01001010000110000101101001000010000000100000000000001000101101000000000000100000010100101100100101010
00001010100100100011101110011000100100110001110110001010000001000010000000000000010000110001000000000
00001100001000000101000110011010000000010100100011000010100100100100010000000000100101010010100100000
00010110011101000000000110000000001101000001010100000000001000010111010001110000000000100000010110000
10010010000101101000100000010000010100000000010000000100001001000010110100010010000001000000011000100
00100000011001100000000000000010010000110000001101010100010000101000010011011101100010100000000100001
01000100000000011011000000100111100010000101111011100000100001101010000101100000000000101100001001000
00000010001000000000101001101011000000110010110100101000110100010000000010011000001000001100100000000
00000010000001101100000110100100111000000100011001011001111001000000000010100010010000010110100010000
10101100000100000000000000000001000000010001000000010000000000100000000100100000010001100101101000110
10001011101010100110000001010001101000100111001000000010010011000100100000001010000011010000000011100
10000110000001010000000000000000000111000010010000001100110001101010000100000011101001100010100000110
00100000000010001000010000110001001101011010001000000110100001011100001000110000001100110100010111001
00101000000010000000001000000000000100101000100100110010000010010011101010010000000000100000000100110
01010000100101101010010010000010000100001000010000011000000100000011110010000010010101100001001000100
10101010110101000101100011000001100000010000000100010000110100011111110010000010000010101001000000000
11001001000010111100010101011010000101100001001000000001001111001100010101111010000000010000011100000
01000001001100010100000001101110000010111000001000000000001000101100000000011011001010110011100000001
00000001010100000100101000100010011100010100000000100101000000110011000111010000101000001000101000000
10000000001100000001000000000000001011100000100001000001010011100001010011000000010111000000111101110
00101001100110110100010101000001000001010100000010000101000010101000000000000000001010010100000100000
00010100001001100001100101010001000000101001000010010000000101011101001100000000001011000010100110110
01000001001010000010000110100100010000000100010000101000000110011100101000000000011001000011100010010
00000011010000000101000000100101011110001000001001010001100000000010000000000010010101000001010100001
00000000000101010010100000000001000000000010101000100000000010011000000010101010001100000000000010100
10000100100010111001101000110100000100100011011000101000001000001100001111011101100010011010000000000
01001000011011000000110000010100000011100000010000001000000100000100000010000001110000100100000101100
10101000000000000000000001000000000010100000011000000100110010000001010001110100100110000000011100000
00010011100000001001100100001101011110111110100010100000001000000001010000000001010100000000110001110
00001001010110111000000011100001000000000111100000000110000000100011100000001000001100101100100000001
01000011001011000000100000000001101100100000011100110101010010001010110011110001010001010101101001100
