00000000000100000110001001011110101001000001000000100010000010000000010001101010101011100000000010000
01101000001000000000100001000001100110000010110001000000010000000100000001110000110010011001000000000
11100000000101100000100100100000101001011100000010000111000100111010100100000011101010100001101010000
00010100000000110000000000001100000000100001110000000000110001000000010001000000000000001010000000000
00110000011100010011001110110000010000000010000011001010000001010011000000011000101110100101000101000
00010000110101010000011100001010000001001001010010001010110000000100000010000000000100011100000000100
01001000100001010101110010010001010100010101111001100011000100100010000101000010100001000101000001110
00000000000100001011010000011000000000000101001000001010000000000000101010100000010110001010001010000
00000000001100100000000011001101000001011001110000100110000100000011001100110100000000000100110000011
10000010000010110010010000100000011000011010000000000001010001010011010010100000110010000010111001011
10101100000110000000001000010100000000111010100000000001010110000001000001010001011000001100010001001
11100000000010001101110010101001000111000010001100110101110010000001000000010010011011111111000000101
01000000000000010001000000000000000000000100110000000001001001101100010001101100000010011001101100000
00100000010000101000101000001000100010101100000010000100000000010000001010001010010001000001000000011
00100000000001000010111000001000011010001001000000101010001000100001000111001100111010011100000111001
01101001101000001000010110000111000000010010011010100001000100000000000100100100000001000100000001001
01111000100100001000110010000000001010000000000000000100101001010010011010111001111000000001100110010
00000000000110100010001100001011110110000000000011110100001100010010110101000000001000000011000000000
00010100000101010100100000000000000000011000100000000000010000001111000000110001101011001000010000000
00000100001000001110001001000000010000000111001100010010010001001000001000000000101100000000100000010
01001101000110001000000000101000001000000001000101011100010010111000010001100110010000001000000000010
00001100000010001001010000010010000100000000000010000001001100001000100001101001010011001000100000011
00110001010100001001000001011100000101100101000100100010011000001100101001000001000101010001101110100
01000000001000001000000001001001010100011100101001110010101000000000110010101000111000100011000000011
11001001000001000011000000010100011000100100111100000000000001110000110000000001000001001001000000010
01010010000101110110011000010000000100110001011000110000001000000000000100100101011001010011100001010
00000101100000001100000010010000010110001011001111110001000010100100000010100110000110100111000011000
00100100100000110100000000000001111000001111010001000110000010001000101000100100000100001010000100100
00000000001010000000010110000100011000000000110000000011010000001000000000001000001001001001011000001
00010010000001111001000000010001100010010101111011100101000101001000101000000000100000001111000000010
01100011100010000001101111101001001010000010000100001110000000000100100000001010010000001000100001011
01001100001000011000000100001110011001000000000000011100011000001011011010000010000110000010000010100
00000101000101110010110010100000100011001001110000000000100000101000010000001110010011000001010000111
01001001000000010010011011000011010010000000000000010001000000000000001000010000000110000001001001111
01001001000100000000101101010111000010100101100110000010000010000000010000000000101101001010010001000
01100000001111000100000000011000101001000000100000100000000101111110000000100010100011000001000110100
01010110111100000000000000010001000000000001001000010010000011010010100000101100011100000000101000010
10000011101000000000000000011000000001100100000000000110010000000001001000010100000000010010001100000
00100010000101011001000010000100010001001010001000000101001001010001000000100000000111010010001001001
01101101001011101101001110100010010001010111101010100101101101100100001010011010000110000010000000000
00001001001001010000110000000010000101000001000100000000001000000000100100110000000000011001010011000
00000010100000100010011001001010000000000001001000010100000011110100011110010001010000010000000000010
00000000101000000001101000001000010100001010001000011000001011000000000000100011000000101110001101010
01100011100000100000110100001011100011000001000011011000000101001011000100000000000100010000001001001
01010000110000100000000010100010000000010001000001001011001001101000000010101000110001100100001100110
00100011000001010110000100110110001110101111001110011111000011010000000010000011001100010001001000010
00110000101100011110110000011101001010000000000100011110010000001000000001010100101000000100100000000
11001000110000001000100001011000000101000001001001000000111010000010101100000000011000010001000000010
00001000010001110100101000001100001000000111000100011101100001000010001000001100000100011010010010000
00000000011101111001101001011000001000100011111100000010001000110100011011001001001000100110001011000
00010100010010010010000100011010110001010100000100100001010011100010001000000010110000010110000010000
10011000100000001000010000001000001010001010001100000100000001110001000000000100000111000000000111000
01100001001000001010100101100000011000110101100000000110010010011101000010011001101000001000101100000
00011000000110000011100011110001000100110010010000101100110000000011000000010000100010001000001100000
00000000000000110100010011000000111111100101000001010100101000100001001011010100001010010000001001101
00100001000001001000010010000101011000111000010001000101010010000110000010000010000101111000100000000
10000010000100001101101000011001010010101001000010011010000010001110000000000000010011000101000000000
11001001100001000000000100010001000001000010000101101000101011000010000000000000000000010001001110000
00000000100100011000000001101000000100011000001001100100000000101000000000100011010000000000010110100
00000011010101001000001000100101100010000000111100000000000011000101100010011010100010100100101010010
10001011000100000011100100001000100101111100011101010000000001000101010000000001010110000011000100110
00111100000000110010010000010110011000101001010010101100000010000100001100010101000000001100010011000
00000000000110010000000010101010100010000000100110101000000100110011100010000000100001001001010000000
00100000000100001110001010100000001010000000000000100101110101000100100000010001110001100000010100100
00001011100010010100000110100100010110000100000010000011000101101111000001001010011000010000100100110
00000010000101110001101000100000100000000001000000000001010000001001000110011010000010000000001100000
10000001100100101010101100000100000000000000000000001101010010010000101000110000010000011100010001100
11000100100000010100100010000000001011100011001010010000010001101111000000010000000010000100000011000
00010000000010000100010001000010000001000101001100110000000000011000000001000110100100000001000010000
00000000000010100000010000010001011010001010000100101111001000000000110000000000001010010000000010000
00000001010001001001110000000001000101000000001010110111000110000101010010000000000100000000000100110
10000000000001011000001110010001000100000111001011100001010001001000001010000000000011010101010100000
00000000001010000100000100000010111010110000100100001100000000000100010100101011001001100001000000110
10100100011000010001000100000000000010000010000010100010101100100001110100000101001000000101110001111
11000110001100001101010010000110000100000010000000111010100011100001001110001101000000100110011100100
00001000100010011001100100111100001111010101000110001000111101010000000010010000010100010010111100011
00001000000010011111000011111000000101000000001000100000010000100110111100110100100101000000101000100
00101010000101000000000011000101000000000100001110000011010001100001000001001010010100000000001000100
00001001000001001000000000110110000001000001000011000001110010101010010101010000000000010011000001000
00010001001000100100110000011011100000001101001110001000001100100111100010010100000011000111100001000
00000100000011000010100000001000010000000010010001001101110000100000100000100000100100011000001000010
10000000000111100011010000000111000000000010010000000100010100000000010000001011101111001000001100000
00110000110000000011000101000000001011010100000100000011010000100100111000010001101001010110001001000
00010010000000000010010000100101110000001000001000100000000100000000101001001110000001010000001000000
10111001000011000100110000100011110010000010000010000100000001000001010001000100101100010000000110100
00000001000100000010001000000001100110010100010001010010001010001000000101110000000000010000110010000
10011111100000000000000000000100001011110001011001100110010010110000000000111100001100010000010000010
01010010100010000001001100100101000110101110010101100001000000010000110100000001001111001011101000001
01000001001011000001100001000001110001001000000000001001000000011110001000000001010000011000000000001
00000010110001000000100010001000010101111000100000001000100010100001011100001000101110001100000110001
11001000101000000010010000000100010000100110001000000101100000000110010101000100000011110011010001010
00100000100010111010000000100010010010010110100001101000100001010010001001110000011001010111000000010
00100001100010100000010001110010000001010000001011001001010000101010010001000110011101101000111000000
10110100110000101100100100101111000000000111001010001001101010001110111001010000001000000111010111001
00011100001000100100110000010000001100000101101000110100000100000001001010000100010001101010011001010
00000000000101010001000100000001001000000110000111100010001010111000110001000100000000000010000001011
00001110010010000011100000000001101011111010100001100000011100010001101000000001100110001100000000010
10000101101000101010010111100001100000001100001000111000000001010101000011000001010111011110100010010
00000100100100010000000110110000011110011010000100011001001010010010000100010110001001010101000001100
10001010000110101000001000010100001000101110011110100101101010000101000000000001100001011000110001010
00000100000000010101000000010110101000001001000100001001010000000000000110010101000111110101010011000
