00001000000000011010001010000001001000110001101111001010000010000010101010001001000000010110001111100
01001010001010101000100010111100101010001000110010010001000011000000110000000101010010010100000100011
00100101001111000001011010010011000101100010000100110011000101000001111000000001000000000010001001000
10011000100101000000100000100011100010100101000100001011000000101000101100100000000100001100100100100
00101010000100001000110100001000000000010010000100000001000000011100010001011000100111001010110000110
00100001100101000101000110101110110101000000100001010010000110101000110001011001000010000000001100000
11000101000000000000001101000000011100100110000100000000001000001000010110001001010110000110000010010
01010101010000111000011000010001000010000001000110110010000000011000000100110110100000110000110000001
10100001010000111001010110010000000101000000100000011000001100111101001000000000101000000000010001000
10010000001011010100110010000001010010010001110110111011000110011010001000010000011011000110100000000
00101010010001001010100011101100001000100000100000000000110101010000111001000100000001011110000000000
00001000001010010000001000000000010010000000100101101100001101000100001001000000010011111001010001110
00000101100000000010000001001101000100001010010110100100000001000001011001001011000011110000000000001
00000001010000100011101101100000000000000010000000000000110000100011010101000011000101100000000001011
00111100101000011011010000000111000000100010000101010000010100001100010101001000100000000010000100010
01100000011101010001000100101000101111111010000000000001011100000011000000101001000100111010000000100
00010000100100000010001000010101111010001001000100111011100011111100110000001011000000100000000100001
10000110000000100001010001001001000000000011100000001001000001000000011100100010100001001001000001100
00001000000001001010100000000001100000011010100010000010011100100000001100100000000100000010000101100
10010000010110001110010001000000010111000001001010011100000001110010011001000110010000101100011011101
00000010000111000111010000001010101001010000101000000000000001001000010000001001000100100001000001110
01011001101001000010001100011101000100110000001010000100000000010101001010100000000000010000100110000
10001000100000101000100000100101100100000010000010110001000110000000000100010111000000100010000101010
10000011001001010000011000100000100011010100001000100010000100000000000010001001000110100100001111001
11011010000001000000000010011010011001110100111010000001100001010101000100110110100010001000000000000
00000000010000100000010000010011000001000000110101000010000000000010010010101000010110010011010000110
11001011000101010100001000110010001000011100110011101101000101100010100000000000100100001100001001000
10110100100000011011110100010000000100000001100001101101000110011000000010000001000101101100000001101
01001010010000000110001111001000000010000010000110000000110100010011100011100000100010001100000100110
00010001000100000100110000000100001100000000011010000001001000000101011010000000011000000100000100010
00010010010000001000001100000100100000000001101110011000000001101000000010001110101001110100010101010
10011100001000000000011011110100000001000000010110000000000010100001001100000001010000000010100001000
00110010011010001100001001100000000100111010001011000011101111110001001000010110000010000000011100000
10010000010100000010000011001000011000010000110010001000001000110000010000000100101010001001011000000
00100010010100001011001111100110100001000000000000100010100000000010000001010001100100100000000000000
01000100000010000101100001011101000000010010100100111000100010000100001100011101010101101010000001001
11001000000001000110100010001010010000100110101000000101000101110011111101111100011000000000010100000
11000011000000001000100000011111000000000000100001110101011011011000001110000100001000001001000001001
00001110000100110110100000001010000010010111000001000000001011111010000100001000100000110011010100001
00101000010011001100110101010011000001010000000010000110010001001000010110000000110001000100010000111
01000000010010001111010000111110011000100111110010100000001101100010011100111101000100000001001010001
00010000000000001000011001010001011101100011011000010001010000010000010000010000000111110110011011000
01000001000010110001000010100010000000010100000000000010010001000100000000000000001000000100011110000
00010000010000000101010000000111010100111101001011001100000011000001110000100000010000011110010100010
10100000011001001100100000000100000010001011000001011000001000000011110000011000100001100001110101111
01110000001010011010000000000000101000101010000101010100100100000000111101100010000000010100110001000
00000100000110100010100110010000000000100100000000000000010000001000000000101000110000011000010010100
00000011000001100001000100000001000000000001000110000010010000010010101001100000010100000000001011000
00000111000100001001001101000000000000001000000100000001000010100000001110100000100000011101100111001
00011001001010000000010101010100100010010010001000001100000000000011011000010100110000010110000000100
01010000110000100110010010000000101000101110010001000011100101010000001010010000011100110101001000110
11000000000010000100000001000101000010000000000000000001010101111100010011010000010000100010011000010
11000000000101100010001110000001000100100000000000000110001000100100101000010001000010000001000000110
00001001000010001011000100001100011110001010010011000001000111010000001000000001100100010100010001001
00000101001001000110000101010001000000100000100000000001100100101111001000001001110101100001011010000
11110000000000100011000101000000101000011100100010101001000000001010111000110101011101011010100100000
00001000010000101000001110000111000010011001000010110110000010010011010010100110001010001000100110000
01000100100010000000110110000101010111101000100100111111001000100100111000010110010000010010000010010
00100001110000011010010110010010000110010100000000000101010000000011000000000111000011001001101001001
00000000000001001001010000010000010010000001111000000010000110000000101111000100010110110010001101110
00000000000001001010101010111001000001000100001000000001010001011000000011000101110100001100001001101
00001000010001000010110000110100001000000100001001010101000000011100001000100110001010001010110000100
00000101101000001010001101101101101000110001000110001001000001100001000000000010101100000000000111011
00000010010001011100000000001011000010011110100000011110011001010100001001001100010100101001010000010
11000000010010100000100100000000010000000000010101010001100101010011101000110010000100111001010001010
00010000000110000000100000110000100000001110000000100000010000110000100011000100011111110101000010000
11110000000010001001000100010001000001000100000100110100001100001101101001000010110010001000000100000
00101000000010111000011001101111110000000011010001000110110011100001010001011100111010000010001100000
00000110100001110000100010101010111100110100000000001101011100010000010111101100010110010001000001000
10010000001000101000000000110000000000001011101000001000000010001010100101010001000000100100010100001
01101000110000000000010110000000011011001100101000100111010110100000100000010000000100000000000000000
00011111001011110001000001000000001001100001110011101010001000000101001010100011101000010101000000000
00010000010000000000000000000010000000010010001111000000100001110000100001000010010010000100000001000
00110001100100101010001001000000100100010101001010110100101010001000000000000000110000100101000100001
00000001000000100010000100010000100001000011100100000000100111111100010001000100100000000001010011100
01100001010100110000001010000100010001010000100010000000001111001000000000010000001010010101101011010
00011000010001010110000010000011010100000000000000100100010000100111100100001001100010011000000000011
00101010000001011010001000000010000010100101100110100000000000100010011100000010101010000000100000100
01001000001010000000001000111001011100000100001110100000000111000000000000010000100001000010100000010
10000010100001000001010100010100000010000111001001100000001000101010000100111000010001001100000001100
00111110011000110000000000010110000010000011010000000010000011110001110001000100010010000000011011000
00111010000010010000011010000000100001100111100000000110001010000001000010001111000010110001000101010
01000000110111101101110000010101111000100011001000000010000000000100010000001000100000000001100010000
01100101100000000100010001000001100011100000000010001010011000001000100000001000010010100100000000100
10100001111100100100010010000000000100110100001001000010000001001000000010000010001010010001010000100
00101010101000111000100100110100011000111010000101010000001010001000101010000000000010001001001101100
01011011010000000100110000000100001100100000010100000100101101001101110000001000000001110000101100110
00100000001000000000000010111110010000000010111001010100010010101100000000010100010011001000101011001
00110000001000000010111001000000001010010100100000000100001000000001101000011010000000000100000011100
00000000010110000100000010000100011001000010010110000110101010011010100101011111000101101110110000011
00100000110101001000001010100101000001110000100000001000010100110000110001110100001000000101000010001
00000000110000000100010000000001010101110010010000000101100100000010000010001110101110001100000101000
00110100010100000000000000001000100110010000101000000110000100110000001000100011010000111000111011100
11001001000100000010100000001100001000010100000000110110000100100000110010000011010001110111000001101
00100000101000110100100000001001111000011001010000000110011010011100000000100000100011100011100000000
00100001101000000011000011100000100110010000111010100100110010001010001100100000010001010000000000001
01100110110000000100000100000011001101010000000101001101100100000110100101010001000101000110000000100
00001001000000100000000010001000010000110000010000001010000110000000000000111010100000111000000010000
00010100101000000000000000001000000000001011000010100011001010001000000010111000100011000011100100000
00100001000110000000100001100000110010001100001000000000001111101011010001000100100001010100000000000
01010000000001001111010100000100110000011000000001100000000010010010010000110001001101101011110101010
