00101110001110000101110101010101101011100000001100000101001010001000100101000000000011001100000100001
01000001000000000000000000110000000010011000001010110000000100001101101010110010001000000101011000100
00000100101000010000111000010010110010111100001010000111001101110001101010110001000001000010011001001
01010101000010010110010110111000010100110001000100011001010000000000010001110000000100010110100000000
10000110100101110100000011000010110000011000000000111110101000000100000011000000100000110101110110101
00001000000100000101000010000000001000000000010010000000100000111001001001010000000000001010100110110
10111000001110000101111110110010000100100100100000000010100000000101000000000110000110000000011001110
00000100001000000101110000000100000000110110010010100010101010011111101001001000000101000001000000001
00010000000000000010001001000000010100010100001000000100100011000000111001100000101110001010000100100
00101011001111000000000111000010000011100000111001010101000001000010010001000010000000101110011000100
01000011001110000000011011000101011010101100000010001000001101000110000101000000011100001101100100001
01000001010011010110010011000000011000000000000110011001001100001101010000001001100011000010110000000
11001000101010101100000000000100010001010011000000010000101010011000000010100010000100010000011000000
00011000100100010010100100001001001010100011000000010010000000000011000001001100101000101000001000000
11100000010010011010100000010000100000000000000000001001000010100101100001100010001001100101000010000
00001001010010001010100000000011001110001010000000000001000010101000100001001100000110000000000000000
10011001000010010101000001000001100000100001001000010000000010000010000001010000001000000000111010001
00000100100000000010000101000000000000000011000111111011100010000001000010001000100000000100001111000
01010000011001000000000001001000000100010000110000110011010100101111100100110011010001001001000110110
10001000000010010000000000001000111000111000110000011000001000000010101101001100000010101000100000100
00000101010001100011000110000010000000101000100000011100011001000100010010010011101000001101000010000
01100100000010001010000010001100000110000000101010000101100101000110000000100100101010000100110000011
00001111001000100001010000000010110010001000000100010001000010000011000010000000001001000100000010000
11000010101010001000000100110101000001000101000100110001011001000100010000111100100100000010000010001
10000001000101000000011001111000010100010010000100101100001100000000100011101001011110001000000000000
10001000000001010100000001010011000101111001000100010010110001000001001101001000011101000101001000010
00011101000000100110010010001100100011000000101100100011110011010001010001100000000100000000000100010
00001101000001101000011010100110000000000000000000000000000000100000010001010001000010011110100011010
10000001100000000000011010000111010100100000001001001010000111000111001001100000110000000110011000100
11100010100000010000000000001010010001100100100010100000101000010010110010010000100000010011000000100
00101000010000100000001100001000001001000010000000101100110100010101000001000010000010010100000101100
11010011001000000110101100111010110010100010010100010000110001000110001000000000000100001100000001100
00010000000000000000010001000000010010100000001011001110001000100000110000010100001000110010000101000
00001000100100000010000000000110100000000000000101110001001110000100100010000100001000010000001101001
01000010000011000000001000110000000000000000000000100100000101010110100000000000110000011000100011001
11101000001010000111010000001000101110000000000011010001000000000000000000001000000101100000010100000
10101010010100010010000111000000001010000000001000000000000010000111111100100101000010011100010000010
01000101000111010001001110000000001010000000001010000001110100101010000011100000000000000100000000001
00000010001010110000000010001000100000000100001001110010011000000001000010100110000000100100100010000
10000101000101001010001000001001001111001000001010000110000000100100000010100001101110010010100100000
10001000100110000100001100000000000000110010000001010000011100000001010010000100110010001001100000010
11111000010101011000000100000111010011110000010000010000101101001110011000011000111011100111100101110
11001100000011001100100111000110001000101000000010000000000100000000010001100010001110000100000000010
01000111110001000000110101001010011000000000100110010100001010001100000101001010011010000000011010010
11000100011000000000000010110001010010000001011000010001000000000001110010000110000010010100000001001
00000000001011000010010011100100010000101000100000110000001001011000100001011000000110001000000011111
11000110100100011000000010100010000011011001000000000000001000000100110011000000100000010010010000011
01000001011000100000000001100010000000001100110111010010000000011110000001010000011001000101000010010
00001110011000001100000000100010000101000110010000001001000001010001000010010111000000011000010001000
01100101000000000100000010001000000100001100001010110111000000001000101000000100000001100000000010010
01011000010100010110010110010000011000000100100101100000001101001100001011011000101000100010100100011
10000000011100010000011000000110000010000011001000101000111100000000000001000000010000011001000001000
00110010101000011000110000010000000001001110000000101110000011010000010110010110001111001010100000101
00100100000000100000100000000100010000011000010001000111110100000000000100010011100000011101000100010
00000110110101000010100101110010110010000010111100100101000000001100111000000000100010001100000000000
00100000001010000000011000000000010000001010011011000101000110001000100000011001000000000000001000010
00100011010100000001000000100010100111000110010000000010100111000001000010010100100110010000100001101
01100001001000001001000101001110010000000000100000110111101010001001001010100100000100100001001000001
00000000110000000001000010100001100100000100111110010000100010001100000000100001010000000000000010000
01010001101010110110010000000000101000010010010010010001001100010011000100000001000001010010001011110
00000001010010010011100000000000001011100000001001000011100000010000100010010000001110000100101011001
10000100010010000111000010000001000010000110000000100100000010100010001001000000010100011010000001010
10000100010010100000011001001110001000010001011010001001100000000001000110110000010101000100010000000
01000010010000110010001010011000000010000010000001000110000001001010011100000000100010010101010001010
00001000100010100000010101000101011011001000000010010000100110001001111000000001100001110000111100001
00001101100100011100010101001001000000101000110001001100010000010000010001010000100101101001000000001
10000100000011010000000000110000001001101000100000110010100010010010000001100100100000010000000000010
11001101010100000011110000001000000000100100001000001001001000010010001000001110101110111100000010000
00000101100000100101000000001100101000001010011100100000000000001000010000101001000000110000000000000
00011000010010010010000110000001010100010101000001000101011000000111100001000000100100010001110001011
00000001100010000100000000001110010010011001000100101000011110101100000010000000100000000000011011100
00001001101100100100110000010110001000000010000110010010000010010000001011001000001011111010001000110
01011000000010000000100010000010010010000000001001001100000000000111000011000001100111010000001100010
00001000110000010000001011111000010010000000000111000001010000000101100010110001010000001010010111000
00010000000100000000101000100100101101110101110010000011110011010000100000011101010000100010001000000
00001000000010000110000101000001000111001110000000000001011011111100100111001000000001000100101000000
00010000000011101010001001000000001100000000010010000110101100010000111001001000000001000001000010010
00100101000010110100010010100001110000100100101001100000010100100000000000001010000101100010001010000
01000000001000000110000010001111000010100111000010110000000100111000000001100001100010001011001010011
00001000000000000001110000000100100101011010001001010001000101101000010000001110001110100010100001011
00010000000011000000101000101010101100110011000010000001010110100000000000110001010000000111000001101
00000000101100010000110000000000011101001011000000001000101010100011001000011100010000011100100011110
00010000001111011111000010110100110000000001011001000001001000001101000010010010010110010100010100000
01001011000010010110000010000010011010010000001011010101000101101000010111100010100000000001000100000
01000001110001100010010000000000001000100000010000000000010000000000001011000010101001100011011011011
10000010000101001001001100000111010001000001000010001101000101101000101101001000001100101001100010010
01010000100010000000001010000001001000100100010111000010101000100000001011101000000010010100001000000
01110011111101010100001000000011101000000010000100011001001000010110000100000001010000000000000001000
00100000000010100110100100100100010000100000100010010101010101001101011111011111111000001000010000000
01000001100010010110000000000010011001000000000001000010000001111011010001010010001100010001010100010
00000001001000000010001010101000010101010000011101000000000101000000010101100100000011101001000001001
00010010100000000100110100000010010000001001000001010001000001000011100110010000001100101110000000010
00100001000110000011010000000001000011000001010011101100010001000000100000000101011110100111000011000
10010000000000001001010101100001001100000111101000011100100111111100010000000011000010100011000000000
00000010000001000010000011110100001001101000100000101101000101000010000010000001001010000010010100001
00010000000000010000110011010000010100110000001000100110000010110010000011000010000100100011001010110
00010000010001000101000000001000011100001000000000011110010000110010100010000001000001101000000001100
00100010011000011100000000101101100010011001010011110000100000011000101001000000000100000001010001010
00000100000110001101001101000000100000100011001000100101010011000100001010001100001000000011000001101
01010001100100100100100011111001010000001100100001010000000000001011001000000000100010000100000000110
00010110000001000000101000000011001101000010000100010001100000000100001110000010001001000100000100010
