00011000100101100000100101001110001101000001001110100000011100000000011010100000100000000010011000000
00001000110101110011001100000100011000111000101000010011000010111000011101110101000000000111000000110
00110100000000100001100101000100000010010110110100001100100110001001001100000001010000100001000000100
01011001010000010001110000000010001101010001001001100001110000000101001001010101001001000001001010001
00000000110000110110000101000001000000000000000101000000000001001100011011101110000000010001001000100
10101000100000000011000111100110000001000010000000011100111010101001101001011111000100000001000010010
01010010110000001110001010001100110000000000110010010010001010000010001011001100100010100001100001110
01100111000010000001000110000000010000011001001101000000011000011001100010101001101000000100000100101
00011001000010010000000000111010100111001000110100001001011000100001000100011101011000000100000001000
00100101000001001000000001000011000000100010001011010000100010101001110010111000101000010000000100010
00101101010000000110000100100010000000000000000010001011000000000000100000010100000110011010110001000
10001100000010010010000100100010110000000011010000001010001001001101110001000010000000100010010111110
00100000001000001010000111100100001001000000010001110100101010010100111000011010011101000100100000000
11000000101010111001000101000111001101010011101010111011001001010001111001000101100000000010000010101
10000000100000001000000100010000011000000010001100010000100000000100010011000001000000001001010011111
00000011000001001000011010010010100110100000100010010100010011000100001111000111100000000000011000000
10110000010101000000000100101110000001000000101001001000100001011110000110110000011011111000000100011
10110100100000000000010100000000000010010011000110100010100000000000000111100000111001100100011101000
10010101011110001000100000000000000000100110100000100100000100110000000000000000000000000000010100111
00000100001000010100000000010000000000010010000100001000000101001000100010000100100111010000000010001
00110001000001101000000000010000011000001010110000100100000100111010101001010000010000001110001001100
00000000000010100111000001010000001000101101000000010011001011000011000000000010010100000001000000011
01000100000010011111100010000000101000000001101010000000000001010000100000000110000100100100010010001
00000100000010000100100101011010001001000010000000000010001010101110000100000010010001100100010010100
10010010000000011100010000100111100101000100001100000100000000000011000011001000010000010000000100000
01110000100001000000001110100111101100010000110110100001100011000001101000100100001010010101000001000
01000000010010100100011010000100001111101110011001000101001001100000100101011000010000001110100000010
00010110010001110000001000101000011000100001000010100000000000001000010001001110001010001000101101000
00100101000000100110010011000000000100001000010010001000000000010000010100100000100001011011000100001
01100000100000010001000110100100001111010110110110101100001001010000000000000110000010011000000000000
00000101000000110111000100000010010000101010110001001010110100000001100100110010000001100000100100000
00101010000100000010100010000000001000111000110100010010001011001011111001011011000000111100000010001
01101001100000101000110101000011001101000001001000110101010000110100000000110011110001110010100100000
00011100000011000100000100000010110000110010000000100011010010100000001000100001000010000101001010110
00000000000011010000000001000010000010001000000010010000000010001101010000001000001110000001000101011
01000100100000001111100110001011011001100000000001011000100101000110100100010110010000100101111010111
00010001000000000000101000100010001100000010111100000000011000100010000101000001001010010000010001000
10000000000100110000001010010000001100000000011000101000011000000001000100000010001000100010000000001
00100000000001000111000000010100010001101100110001000100000000101000000010000010101100001000000000001
01010001010110110001111100011011010010010101100000100100110010100000001000011100000100101011000011000
10011010011010100001010010000000000000110101100000000100000010010011001000101000100010111100000100000
00000010101100010000000100110011000100000000000011000010100111101000100010110100000000010000100110000
00001010010001000001001001000100101100000000000001000100110001101010010000100000100100010011000000001
01110001001000110000100010101101010110111010001000101000011010010000111100001100000001010011000010000
00110011001001110000100000010101110101100010010000001101011000100000001101001010100100001001011001100
11110100001001100010000000000011010010011100010001000000011000100101000001000110010100100110001100000
11001110100100000000000000001010100010110010000000100010111000110001101001000010001100000001100000000
00000000010011100001001011001100010100100000101001100000001000011010110000010100001100100011000100000
11110000000000001000010000000100001000000001001001010010101100000101001001110000000000110000100010010
00000010000000000000011000010010101001101010001001011010000010000000000100001010000100100000001000010
10000010000000001001000000000100001100001001101011010100000000111011001000010010000110000100000101011
01100001100000001110011000010010010000100010100100000000000101011001000100000011011001001100000000011
01010010000100001000000000010000110000100010110000101010000000001100000101000100000100001101010000010
00100010001010010001000001000010110000010011000101001010001001010000101101100000001010010000100001100
10000110011000011100000011000011011101000010001100101011000010010000000000010010011000010001001000100
00100000000101001110000000000001010000101010100000000010000000001000100000001100000011001001000100101
00000101001110100110000000000000110010110000010000000100111000000001000010010010110001011001010000000
10000010100010000000010000001110100000000000010000000100000000000001010100011011101000000000010110110
00111001000000010011000000100000111100001001000000000000010100000001110000001101000000000111101100110
10001001101100011111000000100000000000001000000000010000100000001110000001101000000010000000001110010
01010101100011000001001100010110100100000100000000100110000010000101001010010010001000000000000000000
00100001000000110110001010110001001000000001001010100111011001001000000010000000100000001011001000010
00010100010000000111000010100010001101010000011000000100000011100010100110101000010000010000000101001
00000010000001000110000101100001101000100011000001010100001000100010010100001101111001001000100010000
00000001001110000010111000000100101100000001000001101000000001111001100000000010010010001000001010001
10110000100111000010101011100100100101000100100101100010010101011010000100101010000010010010000000110
00010010001000000110001101000010010000111011000100110100001010000110000000110000100111010100100000110
00010100100001111110000001000100010010111010000011001010001000000100011000000000000011000010000000010
00101000010000010010110101000001100010000010101000001000101110100000101010111010000000001010000100011
01101000000000000000011010000000000000001000000010000001001011010001011001001001000100001100100110000
10000100011101000100100110100000011000000000010100100000111000001000000010001000000010010101001111000
10001010001001000000010001010000001011000101000000010000000101000101000000011010011000000001100001110
11010110011010100011100101100110101100101000100010000010000100110000100010101000100110101011001100000
01000001000000001101010001000100100001001010100100000000000100010000000101001000000111010010001101010
00100000011010000100100010011000001000000010001010010001010000001000000110010010001101001100010011001
10010100000000000100000100010001100010001010000101100001000000000000010011011010010001001010001010100
10101011010000100000000100000010100010101000000100001000000101010001000000101010111000111111001000000
11010001100010000011110001010000000100010000000000100011101010000011010011010000010000000000010010100
00000001010011000010111000010000001100101000000000010000011100010000100001000100110011000001100010101
01011001100001010001001011101000000000110111001000001000001110000001000011010100000001000001001100000
00101000011011001001001100010111100001010111110011100100000101001000100010001100110011000000000000000
10100111100110000110001101100011011000100001101000100000000000001000001010000100110010010011110100000
00100101000100000100000101010001000100000010010000011101110011000000011010000000001010000000010001001
10100010000000010000010001011000100101000000100000110100000001010110010000011001000100110000010100010
01001001101000001110110000110001010000100010000010000010000011100001000000111101101000100010100000010
00000010000001000001010000000000101000000010000100101000101010100001100010000110010100010001100000010
10010100010100010101010001001100110000010100010001000000100010001101011001001001110000000100010000111
01111000000011000000101010110100101010100010110101000110100110001111000110110000110101011000000010100
11001000100010001110000100011001110000101011000000000000110011011110000010110000000001001000001100110
10001001011100000011000000000010101100110100001100000001110010001000001000000011000000010100100110000
10110011001000000000001010000111000011100001000001000001010000000010010100100000111101000010001010100
00110010011001001101011110001001101010001000110000110000001101000000001010001010010000000000100000110
11100000000010111100110110100000110101000011001000010011000000000100001000100011110000001000000100100
11101010101000100100001001010001010000010010100000100100000000010001001000000000000000000010001000000
01111000000100000001101000000100011100011110000101100000001000100000101000000100001000000000000000000
00001001100110000001001000010100100110101001011110001010100100001001010010100010101010000001100101000
00000000100110101001100000010111001001100011010010001001010000000000011101010100100000000001000001000
00010101001000010101000111000001000010000010000001001100000000000000101101110010100100101001111110000
00110101000000100000001000011100110000000010001110000000000000100110001100010000000010000001110000100
11000011010000100001101001010110111000100000101100000001000101001101001100101100101001001100101000110
00000001110000010100011001110000001001000000000000010001000101001000010101001001010000000100001100011
