00001001000000000000101010000010000000011100001000111000010010101011000101000010000000111000001000001
10100110001100000001010011000011000000000001010000011110010010000100001000000110000010001000000011001
10000000000000010100000010000011101001110000111010000001000100001000000000000110110100101010011000001
00000110001011010100001100011001010000000100000110100001000001000110010001000000011010110000010100000
01001000100100000101000001010111100010000100011001110000000000011100111110001101010101100100100000100
01000101101101000101010101101100010010000000000010000000010001001001110100010110110000010001000000000
00000100010100000000000101110100100000010000010000011100000000100110100000010110000000000000101001100
01000010010100000010000000100101101011110000100000001001101110000000000000100001100100010000100100010
00011010000110100001000100110010000010101010101000001000100001000000100111010001100010110000100011111
10000000100100000011100000010000100011000001000011010010010001000111100111000000000100001000100111010
00100000010000001000000101000011000000000010001000101100100100000001010001101000010110011011100110101
00111010100010100101000010101001110000110011000000010100101010001000000010000001000010001100100101000
10100100110010100001001000100010000101000001100010100000010000010001011000101010000001100000000111100
00000111101010010000101000001010000111000000001001000100011011001000110001010000101000100010110010000
10010000010001001000100001100011100001000010101100000100110000010000110101001000001000001010010100000
00010000001001010000010001000001100100000010000001001101000000010011000000000000010010010100001010010
00000100110100001011000010000000110000010100000100011101001000000000000010001000010100001011010010000
00110010010101111000010011000110010100001000110100001001000001001000101000001000000000010010001010101
00000110011001001000100001000000001111000001100101000100001100000000101000000001111000110001010010000
00001110000100000000010100010100001010100000011001000001000011010000001110011101000010000000010000111
10001000000000000101101001110011010010011101000101000001000000010000000000101010100100110000001000000
01010101000100011001000000000100101010111110110101001010011010010001001000000001001001000111010100010
01100001110100101100110000011010101000000011000000011000111010000000110010010001100000000000000001100
00000010000000010010000000000001010000111101101010000000100011111000000101010000010011000101010001000
00000000010000000011111011000100101000000110001100100010000000010010001001000000000000001110000010010
00000001101000000100010000000000010100110010000011001001001010000010000001010001000010010001001100001
00000001000100000100000001000000101000110011001000000000000110001000010000000000010001100000010000010
00000011001011101010111000001111010111000001000001111000101000001100000000010000001101010011100001011
00000010110001011010000000000000110000010000010011000010000010011010010000100010001001100101001000111
10011011100100001001100100111100000000001000100110011000111000000000001100000000001001011010110100010
10000001010010000011000110010000100101000010100000010110000000111100010101010010001000010111101000000
00110011001001010000100000000000100110010001010001100001001000010000000001000000001101000110100000000
00100001101001000010000000111100001000011000000010000000100001000010000110000010011101110010110011110
10001010100000000000000010100110010001000001000010100000000000010100100010100001000110001000011001001
00000011000001101010100010001000000001000001110000010000010101000110000000000000011010100001110000000
00100100001010100000000010010100000000011010000001000000110100000010100000010000010001000001010110000
00010000101001011010000100010000000010010110110000100110000001110111010000011100010010110000001100001
00110010110001000100110011100000101000000011000100000111000100000000010001000000000000110111001100100
00000000000001010111010001100010100000001011010100000001101110011000110001000000000000100100011100101
00110000000000000110000010100000010100010001000101010010000110000110000101000000101001001000000000000
10001100000100101100000000010000000001000001010000010000100000000011010000001100000001000101010010001
00000001000000000010100100010001010000001001010111001010001100000011011001000110000101100001100101001
01101000101111101000000110000000000000001110001000010000000110100110011011000010000000100010010111100
00000100000000011101110100000100001001000010001011000100001000000000000011000100101111100111010011000
10101100000110101000000000100000011100000100001100001101000001000001000000001000000001000110000110000
10011010111001000100010100000010001111000011000000000110000000001001001001000000000001011000100011000
00100011000101110001100000000101000010000001010001010010000000011101001001100000001111101100011001001
11000111011010100000101001000000011100010111100001101000100010010111010000011000100101011011000000001
00000110000000001000100100001010001100000000000100111100000100000000100000101000001000110000000110000
00001011011100000000010001100000000100000000001100000000000000010000100011111000100101101101010010000
00010100001000000000000000000110110000100011011000000010000100001110010000000010000000010100001011100
10101011110000000000011100100010010110000100100000001000000000000010100100000100000010110010000110101
00100100001010010010001110011000001101010100000010000000100000000000010110000100100000001100000010000
01000000100001010111011000000010001001100010100001000000100101000100001000000001000100100100000000101
00110010000000101001000000111001100110010010000001001100001111100001001100010111100000000001000001100
00000101100001100110100100011101000011001100110000001010010101110010001010101000000100000111101000010
01001001000010010000010100101000001010011000000100000100001011000000101111000100010000000000110010001
01100010001001111000100010010111010110000001001000111010000011000110000000101011001101010100001100011
00101000100100000000000010100100100000101001001011000110000001010000011010000011000010001000000111110
01010010101010000100110011001010110100010001000100000000000100100000000000010001011000000010011000100
00110101000001000101001010101000010000000100111000100111100001011000100000001010100010000010111001000
10000000100000100001010000000000000000001101000000000001010000010000111000100100010100010010100010010
11101000010000100010111010101110100010000001010000100000011010000100010110010000000001010000000100010
10001000111000110000011100110000100011100100001010101010000101000100100000000010001010100000101101010
10110001000011100001100100000010001001000000001000011010010100000000100000110001000010100010000110101
10001110000011111111011010010101101000000001100101001100110001101010010100101100001011000000100000110
01000100000110001100100101100010101010000000100101100010110000011111011100010000000000100100010110010
10101000000001000010010010000111100000000011000101110000000110010000010001010010000110000111101001010
01110001101101110000010000000100000100110000100000100111000001100010101010100110110000010000001010000
01001110010010001000000000001001000011010000000100000000000101101000000010010000010010000001001100010
01100000001010100000101111110001001011000001000101000100000100100010000000000100000101110011001000100
01001000000001000000110010010110000001000010101000000101101000000100010000001010100000001001010000000
10100001010001000101000110100000000010011000101100000100000010001000001010100011100011100110110000000
11010001111001001000111101000100001010100000100010011000000110100000010110000000000010000100000000100
00000010100000100100001001101000001000000110100000100011011000000100110000110000101011001010001010100
01010101100001000000011000111100001001000110000010010010000100101000000110001100110001010001011000010
00000000010111000000011001010000000110000011000001001010000000000000010000100111011001010111000010010
01100001001100001000000000110000001100000101001010010110000010000000000000000010000100010010001010011
11000000110001000000010000010010100110000000001000011110001111000010001110000110001010100010100000011
10100110000100000001101000000000011100100001010110100010010000100000011100000010000010110011001000000
00001110000100100011000000000010000001010000000000100100010000100000110110110000011010000110001100000
01100010010000011010110010000010000000110010110001011000000000100101100010110000010011001011000000000
01010110010101000000100010111011000000100111101100100000000000001000011101000100001010000110010000000
00101100100001100010000100010100010100010101010101101001000001000100111100011100010101000110010000110
10010000000101010010000001001000010100010000110000100000000010001000010001010000001010010100101000101
00001100001001011010110100000100110000010010010000100001000010100001110000000100000101001001100011010
10100100010001000000000101000100001001000011000000101010001000110100000000011101000000100000100101100
00000011111000000000010100101101110011000000000100001000010100101001010101000100000001001100000010100
01000000000101001101110000000010000100101110000100001100001000000001010001000010101100001100001100011
00111010110001001010000000101011000001011000100010101000110110100000000000110010101100111000001010000
01110110010010110110100101000001100000100100001000011001001100010000000001010110001000100010010000001
01000110000000000001110001000010111000000100000101001001010000001000000001000100010100001001011000100
01101000011100001000000001010010110101010100000000000001110000001100000100000000100011010010010001001
00011000010000101000000010001010001000000111000101101000010100100111010101110001100101000000000010011
10000100001000000000001000001010010101011100011001000100000000001000001000010010000000001010001111010
11100011010001000001101011101100000000000111000101010110001001000010101111001001100001000001000010011
00100011100110010110101011100110100001000000110000010000011000001011010001001010000000100011000000000
10101100000010110000010000100100111001000011000100100000000010100110010000100010000101001001000110000
00000000010010010001101000000010111000101000011010100100001100001010110000100100000000010000100000001
01101110110000000000000001011001010000001101011000000101111101000000000100100000101000011110000001000
00010000001000110000000100011000010000000001101100100001001001100110010010111010111000100100101010100
