00100110010000000000000000100000011000000001000010011000000100010100010000001100000001000100100111101
01011000010001001111010110000010000001000101001101010011010100011001000100100100011110100011100101010
00000000000000010000001001011000010010001000010001001001000000000001001110101001010100100000000101101
00010001011000000110000001010101001100001000100010100011000000010100010010010001111001000100000011000
00000101011000000000110010010000000000010000000010000000010001010000001011100000000010100101100010110
01010111000001000111000000000010010101000001010001110101000000100000001100010000000001001000010000010
00010100100100000000001010100101010100001001000000011000000111000001000001000000111001000001010001100
10100000000100000100000110000000100011101000100010011000000000011010100110000100100000110001010100010
10000100100100101001011000000100000000111100001101111000010101001001000000000010000110110110010110000
00101111000001010000011000000000100101000010000011110011000000010101011110010101000110010000000000010
10000101101000100100000000011100000000010010010000001010100000000100001000000111000100000000000001111
01010100000000001010000001100001100001000101001100001011010111000001001101100001000000000100101000000
00011000001001011010010100000010000100000100001001001000100100010000011000110000010101000000100011000
10000000010000000010001100101110101000010010001010000010000100000000000001010101000100001001010000000
00000000100001000101100110000010000111011110011011000010111000000110110010000000010010010000010001000
00000011101101011100000000101011001001001100000100000100010000110000010001100010001100010010000111111
01100011001000001001000011100000100001100000101000111010000010001100010000000000111100000000100011100
01101000000100000010100001100110100000000011000000000010000100010000001001010001000010000011011100000
01000101000011000100000100010000011000000100110000100111000000100000000000111100001000101001111000100
00001100000000000000101010001000100001000010000001000100010010101011100101010101110110001000111100110
10010111001010000010010000110010000000000010000101100101001000001000100111101000001000010110010000000
00001001010000001001100110011000100100001000000000001111100010001100110001010000001000111001010001010
00100100100000001000010110000101000001000000000100000100000000000001000010000101001000010011100100001
01000000000000101101100100000011000110101011010101001100000111001010101100110100000010000100101010010
00000010011100000000000010111001100000001110001011001000000100010010001010011100001000001100000000000
10110000011000100010000000001001000010010000010001001010000001000000111010110001101010111101000011011
00110000001000000001000110000000010100001000101000010100100000010100000011000011110011010001110011000
11000010000110000110001000001000001001000010100101011101000100000000000101000101101111000000001000000
11010010010110000000000100000000010000010010010000010010001001000000011100010011000101001111110100010
10010010000010000100010011000100000011100010010101010001000000100000000000110100100100101001100010111
11010110100001010100000000010001111000100011001000101010001000110010100001000000110010100000001100100
01001100011001000000000001111000100101000010111000010110001010000000000010010000011000100000001110101
01110010101110000101000100011000000000101000001001011100010000000010000000000000100000010000101000011
00010001110001001010100110100100100000011000100110111000110010011001000100100010110000101101100000001
00000000101000010000011011000011010100100001011010010110100101010010110000000000000011000100100100100
00000000100001000000100011010010010001001001000000100000000110000011010101000001010100001000000110000
01011000111011001100000000010000010000010110010000001010000110000001101101010000000000000110100100000
00000100000000001010010111100100011001100000000001001000000100000001000000010000010000000100000000101
10010100001001001011001100000001011111000010001100000001000111010000000001010100010010000000100000100
01010010000011001100001000000000100011000000000110100001100100000001010101000001000011001000100111101
01101100100011111010001000100010000010000001000000100000000010001001000010001000100010100001100101100
00100010000000101100000100011010101001100001001101001100000110110100000011111001000001010110000101000
10000001000101100100100001101111101010011010010010000100110100001101010000010000100000010110101101000
00000000010111011111000000001000110000000010010000100000100100000110101010110100000001001000111000100
00001000000101001001000010110100001100101101001101000010100010100101010101000110011011000111010010000
01010010100100101010010100000100100000010000101000000010010000100100001100100000001000111001011000100
10001001001001000101001000111000000100001100001110000010001000010100010110100110000010100000000000000
10000000101001111000000000001000101010000010011000001000010100000000000100010000001101100100011010000
00001000000000001000000100011000100100100100000000100101100100010010110101001000000000011000000111000
00100000000111000000111000110000101010110010010000000110010100011010100010000000010000100001001100000
00111100100000111000001010100000000010010101000001101100010000001000000000010000000000110101011010001
01000010001011100000001000001001000100001000101100010100001100101000100110001000110010000001001000001
00100111000010101000000010000001011110101100001100101000000100111100000110100100100000001010001000110
10000000110000010010100001001010011010000100001100111101000100010000110000000011100000000001000001010
11101101001001100000100110000001000010001000100101001000001000100101100101010100001101010101010111000
10000010000100000011100000101000000100000010110000101110011110110010000010000101100000010011110001101
11000100000000011100000010100001000101110100100000110100000000010000100100100010100010010000000001010
10010101001000000101100010100100000101000011100010100100010000100001101000110000001001010010010001101
11000110000000000010100001100000101000010010010000000000010000100111010000000001011010000000100101111
00110010000000010101100001000010100010000010000101010000001010101000001110100010000010010100000011000
10010000010010100000001111100000000110000000000101100001110001011011001000000010011010100000101101001
01010000001000000000010000011011100001001001100011101001011101000000100010011000001000000001100000001
11010000000001000000100101000001010001101000000100010001000000010010101000000000001000110010000011110
01111010100110100110101000100100001010101000100000001001000011000100000110000010000100110011010000000
11011110001010000100000001000000000100101000100100001110001110000010000101000001100001011011000000001
10010010001000000010001010101110100000000010100001010111001100001000000011100001011000001000011000001
01000000000010011001100000100000011010111010000100000001100000011101100101000001000100000010000110100
01000011010001000011000000001110111101111001100010000010001101001010000111110000110101001001000100100
01000011101101010110001000100000100101000110011010001000011001001001110010000011010010000001010001101
10011000000000100000000101000010000000000001011000000000010000100001001001011100000000101000010011001
00100001111001011001010000000110000011000010100101011100000001110000010001100011001111010000010011000
00010100101000011000010011110000111010110001011101010000000110000000010010011001010000000000110000000
00000001101101000000001010001000100001000001100000011010000101010101000001100011000001001001001000001
10101001000100001011010000000010010101000100010001111100111100001000100000010010110011001000000000111
00100000010001000000110001100100001000100001110000110110101101101100100010011000011011000001010010011
01001000000101001000100000001010101000110101000000111101000001000001000101110001100011000000000100000
01000000000100010000000100001000001110010100000110000011110000011010000011000000001100001110000100000
00000100000010100100001101010110001000001010000001001110010000100100001001001100000011000100111111010
00000000011001100000000000110100010000100000011001010001100000000000000000100011101000000100101000010
00101000001011000001000000000010100111000100000111000000101000110100001111011010000010010010001010110
00100101110000000100000001000110100000010001010001000011000110001000100001100000000000010010000000100
10001100010110000000010100001100010010001001011010000100001100000100000100001001000000110001000000101
00011001000001100000010000000100011100011000010000010100010010110001000000000101000111000111000100110
01001101000100000000001000000110100000000010000001001001000000000000010101110001001000100110000010010
10000101011010001111110000001100010100000101011000101000100001001101110001010100100000000000110100000
00000011011010101000001011100100000101100101110001000101101001000000001010011000101101000100000111000
10011101100000110010000000101010100001000010100011100011010000000010010001000000010000001011001100100
10010011000001000011000100000000000000110000011010000110000001000000000110100000100100000000100100000
01000000000010001000110000001101001000000110000001101001000010001000101110000000000111100010001000010
00110100001100100000001001100101101010100110000100100011100100000110001100001010000001000011001111001
00000001101010001000101010010000001000000000110000001001010000000011000010000000010100110101101000100
01000011001100010010100010111001000000000010000001101100010010100000100010100000111011001010000011100
11110000100100000000000011000111000010010100000001000011001101000000100000101010010000110001100001100
01001100110000000011000110010110001010000000000000110110100000000000110010000000011000000110010000010
00000001100101010101000000110110100101000010001011010001001011000101100100010101010110110111010100001
00000100000000011111010000011000000010000011100001011011010001001000100000000011101110100000000001010
00010100000000001011000000010001011100001110010001001101001100000100100100000110010010101110010110000
00000100000000001101010011011001100000001100011001001100100000011000000110100011001010110011010110010
00010011000000000100010000100101000010000110110000000001010100100010000101000010000010000100000000000
01000101100001101000110000010111000001000000001100100101001100110001001000010000100001000011111000010
01100001100000010100000110010100111010011000000110101000010000100000000100000010000000010000000000100
