00001100000011001000001000111100111010000000000000000000001010000000100101000110100000000110101110111
10010000110001001010000000100100000100001000001100000000110000100000101000100011001100000000001000001
00010001000000000011000110100000100100000000100010010101001011100100010110100001001000000001100001001
00001001000100000001000000001000110000000000011110010010000011100000000101110001000100001010001010000
00000000001000101001101001010000011001000110010011101100100001100100101100000000001100000100100000000
00000001000000111000100000000001010001010011100010110000000001011000101011000010100011000001000000010
00000000000000010000101000001110101010000100010000011010001101010100100001001011100110110010011110000
01101000001100000100010111000000111010000110100100100000000101001110000010000000000010000010010000100
00000011101001011110010001010100000000010000000000010001000010000001111000010000100000000100000000111
10011110000100011011000110100000011000110101001010101010000000001011100100001101101001100100000000001
00100101010000000010001000100010010000010001111001001100101010000001000001111000010010100000011000001
00010100111100100001000101100000100101010110000000010110000010000000000100000000010101000001110000100
11000000011100101000000000011100010101000100011100100100000010100010001101001010000000011100000110110
00010000000000001000110000011000111001010101000000100101000010010110000010010001100110000000000010000
01000000010101010010000100110000100011011000011100000000000001000001100001100000111000000000110100100
00100000010100001000001111001000000010110110011011000110110001100000100000100000000100000001010100000
00001011010000000000010001000000000101010001010110000011010010110000100000001000011111110000001001000
01001000010100000100000000110110011000011101110111010010101100000010000010100000000000001010000100000
00011110101110001000011110101000100000000011000001100010011010000111000001001000100000000100001010000
00100000000000101100000010001000000000000110010000001001001000000100001100100101000010001000010001010
00101100100000010000001111100011111100010100000011000000000001000001101000000110000001000101001010110
10000000001000100100000010100000011111000100001001000000001000110000000100100010001000100001010000000
10001100110001000000011100101010000000000000100000001010000101001000110100101010100001000100000110101
00100000000000000000010010011000010100101000000000100000011000100100100101000001000010001100000000001
00000110000100000000110000011000001101000110010100000000111000000000110000001100010000100010001100111
00001010000000000000001000000100101000001000100010001000111000110000000011000000001000000000010001110
00000100010001000000000000100100001010001001101001100010000101000000010010001000010110100000001101000
00001000010000000000000000100000000000001110000100001000100000000010100011000101100000010011001011100
00100110001010100101000100001001010101100101000010100000100101000010010001000011110001000000110000000
10010000100100000010000000010101000001100101000110001000001100001000000000000110000100001100000101101
10010000011010000010000010010000001000000110001000100110001001000000100010011000110100000000001001001
10100000010110001000000001000100100100000000100001001010000011100110101000011101010100000110010010000
00100000001000000100001001011110100001000000000100100111010000001001000000110000000100010100110000010
00000101010000100011000010001010010100100001010101010000110000011000000000100001000000001000111100000
01010110000101100111100000100010001000000101100110010000110101011100010000000000000000000000111000100
10010010010000100010000001010001100110000000101000000101000101000000101000000001000000010110101100000
00011100001011100110000100010011100001010001001100000101010100011000001101000000000100001001000001110
10100010010100000100111000100000010110010011011000110110001010100000000000100010100011001000100100100
00011100000000100000001000101100000100111001100110000000000010010000010010011000001110100100010010010
10010001000111001101011110000100001000011000000000011001000000000001000010000010010011100001110000000
01010100001010000100100100100110100011110000100000000100000110000000010100010100001001000000000010100
10110000000101000000110001000100000010101100100001111000100000010100001110100000000000110010001100010
00110000010100000011000001010010100111100000000010000000000100000000100010000001111110001010000010100
10000111000101100100011000010000011010010100000000100000110100000000011001000010111010001110001010101
00001110010110000000010000000010011110110010001100100100011110000011110010000010100000100100001000000
00110001110001100010000001011110110001111001101011010001000000000100011101000110001010110100001110000
00101010000100000010000110100000001011000000100100100001000000001000000011000000011000100010000000000
10001000100000001100101001000001000010000000000100101010010111010000000000000001110010000010000011110
10000000000100000000000000010010000001001000000000001100000000000000100010010000110001101100001010101
00100001100010001001011111000000000000100000101000000111000000110011010100010100001101000010100011000
10000001100000010000011001101100001011000011000011100011000001000000110001000001001110100010000010000
00100001000000010000000101010000100010110000001001001100001010000001000001101100110100100100000011100
00100100000000011010001000110001010101011000000110000010100110000000010001100000100000011000101000010
00001010101001000001000010000100001010101000100000000100001000000111000000001000010000000000001000100
11000010100001000010000100100110010010000010000001000000010001010100100111000001000110101010110000000
00000010101000101000000000010001100100000111100101100011100000100000010000000011000001001000000001001
11011100000100000001100100000000000000010001000011001001011010001000001000010000100100010001000001100
01000010011010000000110000011000001100110011001001000000000000000100000000100000011000100000001000011
00011010011010001010010010011001000000110100010001010100110101000111100101101000100010000100010010011
00010000010000000011000010010011000000101000101000001000000010000000100110001101111000100101000010000
00010101010001000000000001011001000101000100110000100001000000000001011001000000000110000011000000010
00010110000100000100000110010000000111010000110110000100000001111100000110011000001001000010001000110
01111000001000000010001000100100110000000000001000001011000000000100100110000000000110100101000000010
00000001001000101010100100100111010000001000011000100001101000010001000101001000011010011100000000011
10110000010110100001110000010001100001000001000010001010001100011100001000000000000001000011000111101
10110011100001010010001001001001100001001001000100110000000001000100000010000010010010000001101111010
00100110000000001001000000000001100010001000110100000100000100000000001001000110000110111000000101001
00000101001000101010001010101000000100000010010001000000001100000000111110000000000000000010000000011
01011110001001000100011011101101101000011001110100100111101000010100001001000010000010000001011100010
10001100000000010100001000100101100010001100000101000000101010001000100000110010011000100000010001101
00100001000100000000000110010010000001100100110110100011000001100000110010001100010000011000101000010
01000101111100000001000000010000001010000010100110001010011101000000000100001001001010000001010100000
10000001001101000011011101000100010100000000001010010110000110000010000101010011100100010000010100010
10010001000100001010010000100010101001001001100000100110000100101010100010000001000000000000000010000
00000000001001000011010100010011000000000010010100001010100000100100001000000000110010000000011000010
00011001000100110000001100000010100101100001000100000010100110010101000010000001000000000010100000011
10110010001000001100110100001110010010111000010110001001110010000110000101100101001001000000000000000
00000001010100100000000000000010000010000001011010000110000001000010001011000000100101100010001000010
00001100000010000000000010000000000000001001001000000001011000000011000010010010100011000101000100000
00000011110011011010101000100000010110100100100000001000100011000010111000000101101000011000011000110
11010000000000001010000001000100000001101000010100000000001100100010001010000000101000101010000000000
00010110111111110000000011000100000101100000000000001000000000000011001000010000101000000000101001001
10000010010011000100100010010101110000001010000000001001111001110001000100000110001000010011100000000
00100111011000010100000100000001001000011111001000100101001000100000000000001000000000010010000000001
10111101000001000100100000000010011001100000000101000010010010000000000101010100001001010000000010110
11010110100010100010000010001101001110010010000101100000011100101000100101000101011000001000001000100
00101010000100000111001001000001001001110000110101010110000000100100000010100101100110000001001100001
00001000001011001001010100100010000010001000001010011000010001000010001001100000011000000100000000000
10110011100001001001000101110100100000010000100000000001100100010010001000000110010000000110110011000
00000100000001000010101110100110000001110000000000011111000000000000001110000000011010100010100000011
00000001000000000000001001000001010001001000000010100010110100001000100000010101000010010101000000100
10101100110110001000100110101100000001000101000000111100000000000010000010001001001000111011100001010
00000000000101100010001100100000010000011000001101001001000010000000000111100110100000000001001100100
01000001100001011010000100000000101010000001010010000100101000100100111001010000001010010000000001000
11000001000000000000110101010100000100011101000000100000000001000111000000100001000000100100100011000
10010000000010100000001000000111001001001010100100001010100100000100100011011000110100010000001100010
00110100110011000000000001010011000110001011010100001010000010100000001011101100010001001000000000001
01100000110001100100010001100011000100110000001100000011000010010000100011100010000000011101010000111
00000110000000111001000111000000111000000010001000000000000001100110111110000010100000000000101000101
01000011000011011001110100000010000000011000011000000000100100101010001100101101010010110011100000011
10100001111100110010100111011000010001000101101000001100111010001011100000000000000100000010000110001
