00000001000100010001011010000000000110000010010101000101100001110100001000000000000001100001000000000
01010000001000000000000110000001000010111110000001010011100100001000000000000000010010000010001101001
00010010001100000000000101100001010000001101001001001010000110000110010010110000000000010110010000000
00011101000010100110011010110001000000001000000001000110100000010000100001000101000100010000010000100
00000001100110000001000111000011001000010100100110101110100010000010101000000001000100000000000000011
00000001000000001001100100001100000010000100001011000001011000000000101000110010100010001001010100101
10001001000110000110000000000100000011000010011011010011000100010000110100010000000011000100001100100
01001000011100100000010000011001101000000001100101100000101010001011010001101100100100101101100010000
01001010010011000110000010000000000001011010000000001100101111000010000000001001010000000100001001001
00000100101100000001110100100001010000000000000100010100001000000011000100001101110110001100000000100
01000100110011000001000000000111100100100101000000100000000000010001001100000111000001001010001100111
00010101000010100000000011111010100010010010001000010100001100100000100000001100011110111110101000010
00110011001000000010000011000000010000110000001100010000100000110000010000000010010000010001000100000
01100001001000011000000000001100000000000100001001000000001110100000011101000001010010001000000001010
01101000000001001100010110100100000100000010000001000010100000010101001001000000100100000100100001001
10000001001010000000010111000000000110100001001100000001000011100000000010000000010010000001110010000
10010110001011011000100000000011000010010001011101100000010000010100000011001001000000100001000100010
00110101001100000001000000001101100101001101010001010110000010001100110010100000000011100000011000001
00111000000011000001000010110010101101001100001100000001101000110010101000110000000001100000000000000
01010101110100000011011000110110010000100000000011010001010110011010000100011011000001000000000010010
01101000001011110000011011100101000100110100000000000000010110100001000001000010101001000101000000101
00010001000111000001011000000001000000001101100000110100100100000000100001011010010100000000010101010
01100100000000000110000110000000010100110000000101101011100100101010101100000000001100000001000000000
00010001010001000001000010001010101000111011000000010110001100000000101001100000000001010000100000001
00001111010010110001100010000010000110010001110011110000000000100010000000000000000100001111100000000
00100000110000010100010000000000000000000100111011100000001001000000000000000000011000001010110011000
10010000011101010000000010100101100001111000010010001100111010000000000000000110110001010000100100001
00000001110000101010000100010011001011000001001000100010101011000000110001000000100100001001101000000
00101100010100100000100001011110111110000010100101000000000010100000011000010001010101101011001101100
11010000000000010011010110001000010001001001100000111010000000001100010100000010000000010001000000100
10010100000000001010010000000101000100010000000100010011010100100000000010000100100000000100000100101
00000000010100010101011001000000100000010000010000100010101110100010010101011000000010000000111000011
00100000010011010000100011010000110010100001000000110000100100011000000111100101001000000000110110000
00100100001001000010000001001010001000000110100000001010111000100010011001000000010100011000000000000
10001000110100100110110011000000010000100010100101110111000100101000110000010000001100100110010000110
00101001000110000000000000000100110100110000010000000101010100000000001010001001011100010100001010010
00000100101001010101010001000010000001000110010100000011101010000011000000000000000001100001010001110
01011100000000000100000010100000101000001001111000100101001010000110011000111000000100000000001000000
01101011011100010000001000110000000001000010000010000010010001000000011110001001000000000000000000000
10000000000010010000001101010100000001000010110100110000101010000000010010110010001110000010010010000
10000110000000010010001000000010101000000010000001000000110001100000111000010000000000000100010011111
00100100010001100000101000001001010000000110010000000100110000111010011100000001000001000001000000010
00000000010000011101010010000001100011010000101011000000000100010011000001101010000001001101110001101
00011001000000101100110000100000001010001010000011000100100100001010000100000000001000001000110000000
01000000100000101000100000001000101011010000100000100101000000101100000000001000010101010100100000100
01111101001011001010001001000110100101001000001101000010000000100000000000111000010000000010110000100
00000100001000010000010000111000010000010000001000001000100100010000001001110011100110000010000111100
10000000000001001000000000000011000001010001000110111010010001000011001000001011001110011111000101010
00001000101000111011001000001100000010010100100010100011100000010001100111000010100001001110000000100
01100001011010011000000100100101101100010100001001001011100011010101111101001100001000100111001100000
00100010100000001011100100100001101000010010111001000100000000000001000001000010100000000010000010001
00000110000111000001000000000000100000101000000010001100011000000000000000100110100001001001000100000
11000100010001010101000100100000000000000001000101001001000101001110000001011101000000100101010010001
00100010000100000110001001001010000101100000000000110010010000000010101100100001000101100110000010000
00010110010100100000000000101001100001010101010001000001001000000101000010000110101000000000111000000
11010010010100001011100010100111110100000010001111000000100001100010001001111000101000000100110000000
00110010001100010000001000100000010001101111100000010000000110000011100000001000000001000001110000010
00000101000000000001000010000101010010010000010010010000010001111000000110011000101010000110001110001
10000100011011011100011010000010001101100001000011001000001100010000010000000110000000001001010001100
00000010000001000000001000000100000010100000100000001110101111111111100100000010001001010100001000100
00111001001101100000011010010101111110010100011001001001110010001110000100100110001011100000111001000
11100110100001010010100010000100000000000000010000000100110011100011110001110100010100010001001010010
01101101010010011001110100010010000100110001100001110000101011010111110100001000000010100000100000100
00001001000010000001000111100010001101000000010000100010010100001110000000000100100000010000110100010
11010000100100000000000000101000000000000000000000001001000001000010001000100010110010100110101100011
00001000011011000000000001100100000000000001100100000111100000001000010110010000011001000000100001010
10010110000000110010100000010001010001001110000000100011000100001111000110100000100000010010000001100
00111100010000100000001000001001000000000100001001000001101111101111100100001010100000000010110000001
01001000000010000011110000000110001100011001000000100001010010000110001011000000000110000000000111001
00010000001011001001011100010000000000000011111000010100000110001100001000100010010000000110000000000
11101000010000010011000101010000000011000000100010010011100000010100010010110011100000110010010100000
10000010100110000110111000010101101110101001100000011000000110000000100101000001000000010000000010110
00000001000000001110000100001110101000100001001000000001000001000000000001100100000110001000100100100
11001000100100010000111000010001010000101000000000011101001000110100011010100100010110110001011100001
00110001100011000001111000010000000000000000100010010000101011000000000010100000000000000001000101101
01100010111010010000000100001000100100000000000010000000101000100010011001010010101100010001001101001
10000001101100101101000100000000011101011000001000011100000001000110000100111100000110010010101000000
01011001011001000000000011000100010100000100101010011000100001001000100101100111000010111111101100001
00110000010001010100110010100000000000101000001001111001101110000101000000010000000101010101110001000
00000011100001000000000011001110000011000001101000010000000101000001100010100000000000000100010100110
11100000010000001011000000000001001101100100100000000010000000010001010100000001111001010010101010010
01011110010000010000100000100000001001010100010100001000010001110000110100000000000110111100100111010
10100000001100000100111000000010101100000000011000000000111000000000001100100110111010001000000010101
10010001001001001000001001001001100000000000001100000000000101000100000100000100101101000000010100000
00000100010000001010010000001100001100011110011010000000000010001011000001100111010010100000001001100
10100100101000110010000100100100101000000110010101101110000000000101110001000011011000100001100100010
00000010001010011001011110100000100101010000000000000110100000011000001000100111001101101000100001010
00000110001000110000110000000100000100000000000111100010100110100000000111001010000000000000000000000
00001000100100010011010010000010010001001110000110100001001010100100010100100100000001001000010010010
01001001101010000000100011101100000100001000010101010000010000010100000000000000000001100010010000100
01100000011000000000000100100100011000000000000000000000001010101110110000010011101000000111100000100
00010110001000000000010010010000100100000010011000000100000000010010000100000010000001001011000011001
00010001001000100010100000101000000100000001010000011000001000000000000000101000000000011000101101000
00010111000100001111110100000100011010110100000001000000110000000000000100100001011110010101010110100
10000100000001000001000000000010100000100100101010010110000010110100110000101100101000001000000010010
00100100110000000001101000000000110001000011000000000100001100011000100100100111110101000000000010011
11000110000011011000110001000010111000101010010011110111000110000100000000011100000110000000000000001
10000011001000110001100001000100010001000100111100001100001000100001010000101000100000001011010000101
10100111000000001001100100100100010000000001100001000010000000000100101011010100100001110000010001000
00100001000001100110010001000100010000010000010100010000010000000001100000000100001000100000010001110
10000001000100010101000011110001001010010010011001010010000010000010101000001000001000000001000100000
