10100000010000110000100100001110000001111100011010000000010001000001001111100000111000110100111000000
00100001011101000001101000110001011100110001110111000001011000010010100010111100010000101000000010011
11101010110000000010111100100010000001100000001100000110000101111000001011000010000000011100111100100
01000101000000110100010011001000111010100000011010011100100000000010000000000000000001001000101010110
10000110000101100100010100100011100100101000100000000000000000101110001111100000100000111100101010011
10010011011010010010000001000011010000011011000010000000000000011110010110100000001010010010011100010
00000111101000000000000001001001100000011011001100000010000011000000010000100100001000110010001001011
11110001011001001100010100010000110110011101001101011000001100000100011000010000000001100010100000000
10000011001001001000000000100011000000101001000001101000110101000000010000001100000001010000000101000
10000000100001001000000100001011100100000001100011010000001001100100010000110101010101100001010101001
11100000010000000010011110001011110011011000000011000101101000001010010100100100110100010000010010100
01010100111011110010001100011100000000101010000000100001010101000000001100001001001001111010010010000
00100000000001001000011011010100000001001010000000001010000100000110000010010010000000000010010010000
11000010000001001111000001000000100001100000011011000100000001100011001011110111101000010110000000001
00000100001000101000000000110101010000000001100011000000000100011000000100001101000010000001010000100
00000000100000010000101000100000111000101000000010000100100000010111000010001001001100010000101000000
10000000100000000000001000101001110011001100011011101000000100010000000001000001010000000000110000100
00100000100000000001001101011000100100111010000111000010100001001000001001010100001000010010000010110
01011000000100001010010000110000100010000100010100010100000000001001100000001000001111001110000100000
01000100100010100001000101001101010101010001000100001010000001000000100100100100000001000100000000000
10010000000010000000010110101000000100001100000010101110000000011001010110001100001100000111100001000
01100101001000111101000010000000000000001001000100010101110100000010100101011000001010110001000001000
10001000011100000000000000100011010010001010000001000101111011010000100000110000000100000000000011000
01001100010000110000010010100010000010000001101000000000100001000011010000000000000101010000000000000
01100001100111000010111000000000001000001000000000000000001010000010010100111010110000100001000000101
01000000100110010010010001000100100100011101100000100000100000100011111000100000001000100001000000001
11000000100000101010000100101000010100001111001000010110101001010101100001110111100010010010100000101
01111101000001100000010011100011010010010000010000010110000110001010011001010000010100000101100010000
10000010100001000010000110100100000101110101000011100000101110000000001110100010010001000100010000010
00100000000101000000000011100110100100000000000010000000010100001010000101000110100000110000100100100
10001000110000110010000010000101100000000010001111010010111010000001001010011010001001000000001000000
10110010011001000100001000100001010000000001010100010011001010001001000010100101001010110010011010001
00000011100000000001100100101000110000011000100010000000000000010011011101000000000100010000000011111
00001100001010100011110001100101110000000001010000011001100110010001001100010100001110101010010010010
00001000011110001000101001000000001000101000000001011010001000101001001011101000000000100001000010010
00001010001000111000110100010010000011000001100000100010010110000100001100001101100100110110000001111
01100000110010000110000001001101000111000101001100000000100000110100000100010000100000000001011000100
00010010001001100010001000000100010101010001000000011000000001100000010011001111001010010000000100000
01001001101100011111000001000000000001110000000100010011000010010010000110000000000110011101011100100
00110001000100000110000000001000000101000100101100010001100000101011010010000010001000000010011010100
00100000011010000101100000010000100000000101010100010100100100100000100100000100000001100000010110001
00000010100000000000010000101010100000000010110101010011100010110000001000010000010001101000011001101
01000001000010100000010101001100000010001010000000000001100100000011001001100111010110000000011001100
01100110010011011000011000000001000000001000001000100010100010000110000011100100010010100010010101000
10010100001010001101100100000101001010100000010110000000100000111110001000001001010010000100011000000
11100110010001100001001000000010100000010000010101000101000010010000100111001000100000100110000011100
01000000010111100000000100010010001110000011000000100000000001100010001011001101000000000000101000000
00101010001111110000011010100000010001110001000000100001010000100000110000010010000010000101100100001
11110110000100011110100100100000010010011000100011100111101001100010001000000010000100010000001010100
10000101010000001100001011000010010000100000111100010000001111010000100001100000000010001100101010110
00000010100100010011011001010000011100000000000000011010010001101100011000001001100001010000001000101
01101011100000111110001000001101000000000100001000010010001001110010010100110000110010000000001001100
00000000001000110010001010110100000001010000010000101000100001000010010000000001100110000000000001000
10000101111000101100100100011001110011000100110000010110010001111100110011001101010000000010100101000
00010011000001101000000100000101000010000000001001000111100000111010001110000100101001000101000001000
01001100000010011101010000010000101000001100101010000110010000100001100000110000000101010110110001100
10110010010000000101001101000000000000000111100001001100101000100011000100100110000000100000000000101
00100010000111000000100000001000001101001010101101000000000000100001010110000000010000001000111100101
01000000000100100001000011000000010000110101000010101001110000000010000111100000010001001100000110100
00000010110100111000010100001110010001100000001110000000001100000010000001100110110010111001000000001
01000000100000110100111010001101001001011010100000001100000010100001100010000000001000000010010101101
10010001101000010011110100011100010110000000100010001100000000010110001101000001111000010000100000010
00011000000111000101000000000000001000001000100100000010000001001100001010001000101000000100010010100
00000011000011110000101000111000010100001000001001010001100110010100001000100000011000100000101000000
01100010110000101000000000000001101100111000000000001010000011000000011000010100000000001011100000000
01011000000000001000000000001010100100100100010100000001000000010000000100101000010001001000000110110
10000100100000000000000011000101001000000000000100100010001000000110000010011000000000001001101000010
00110000100010001001100000001011011100001011010001010011010000000101000101000000100010001000011100000
01110000000110010101100000000011010110100101000000010101000010100110000100101010101000000000110110100
01010101010001100010000010000110101101011000000011000000010110100001000000000100101011100001000100000
01000100000000100010000100000011010000010000010110000000000011100010001111000100111001100000100010100
00010011000001011000110010111001111100001100100000011000001101000010001000100101000110000011000010000
00010000100001000000001000100011100000111000110001000010000100101001001001000010010000010110001000000
01111101000101001100100010101000000001000010010000000001010010100100010001000000010001001000010100001
00000110001100000000000010000001010000001100000011010001000110110101111011010000011010000110010000000
00010000010011000100000100000001110000000000001000000000010100000101110000100001100000001001000100010
10001011000010010000010000001000000000000000000010000000101001010100001000010000010001100100100000010
00000011000011110010110001100101010100000011100100000000100011010100011000010000000000101011010101010
11001010000111010001000000000110000010010100011000000010000010101110000000000010001100100000000000100
01100001010010000010110001001000010100000100000101101000000100000011000100101001100101000000010000100
10010100101101100001100000011101000001000000011001010000101000100000000001000111000010001001000001010
01100000001000000000000000010110000101100001111001110000000010001101101110000011000000010010000000011
00001000100001010010000100010000010100000011101100000101001100000000000000110001010100000010111000010
01111100101000000111000010110000100001100000101010011000000111010100100100000101100000011100010010100
10111010010100001001000100100010110000110000010001100000000100001010100000010110010000000001000111000
00010010001100110101110001010100000101100000000000101000010111001001000001001100100000110000000011000
01011100001100000000000110001000101000100000000110000001000001001010001000010001100010100001110000100
00000000010100010101001000001000101000000000010000010000100000000000110000100101001000010000010010110
00000100001000101000100000000010000101000000110100001001010010001100011010000100010000101100010100010
01010010000110001010101001000111011010000000000000000000001000110001111100000100010101000110010011100
01010101010010100100001000001000010010011000000000001000001101011100000000110010100001001100011000100
01000010001000001100010000101100000001000010000100000011000101000100100101000001100101110110100000110
11000110110001100010010010110100000010010000110000001010100100100100000110000010000010000010000010000
01001000011001010000001100110010001010000011001100110110101100000001100010100000001000110101000110000
01011100010000000110000001000011000000111001000010001000000001100101001100000001010000000100000000011
00001010001000000100100000111110011101110001000001101000000011010000010011101000100001001100001010001
00010010000000001010101110110001001000000000000100010010001000010000011000000000000000000010000100000
01001001000100010001000000000100000001000001000011100101001000100000010000000101010011010001111000110
00101001000011000001001000000010100110110010100000110110100010101000000100101111000101001010001001001
00010110010100110000100100110000010110000000001000111001100001011000000010000001000001011000001000010
00000000010100010010010001010000001000001000000100011000010001100100110101010000000000101110000000100
