00001001100110010000000100001010100000000100000101101001100100110100000010100010001100000110000001001
10000000000101011010000100110000100000000100011010000001000000010000010001000000000100010000010010001
00100001000001000000100010100000001001000000010000110100010010100000010001110001010110000001100010000
10000100010000100110010010000010001011001000100011100000000000000000000011100010010000010110100000010
10100111000101100000011000001000000001111010100110000000001011010001101010000000001000010100010010110
00000010011001010100110100001001010000100000001000001100000100100010001110011001000001010110011100100
11000000110100001001000000011000001101000011110000001111101100110100000000000100101110010100001000011
11100000100001001100001100100000000101000010000110010000010010000000010010001011000100011001011100100
00000000000000001000000000111000000110100000000010010001000000010000001110110001101010000000001100001
00001001000001110101000001000000001100010010111010101011010010000000001000001001000110010000101000101
00110000100000111011100001000011000110000000011110011110100100101011001010100110100001010111000001110
00000100000001100100010001010100001110000000100000111000100010000011100000000110000000010011000000101
00100001010100101000000011100000100001000100010010010000100000000000000000111000011001000000100000000
00100000000000100011000001010011000000000100100010111000001011010010110000000000100001010100000000010
00000001000001000100111100000000111001100101000010011001000000000101000011101000000100000000000011010
01001000010000000011100001001010111000000110000010001000101011000001000001101100101010100001001010000
01110000100101100011000101000010111001010000010001000001110000000000010001010100011000100011101100110
11010000010000110101111000100101110010000100000100001000011010011011001010101000100010001111011011000
00010000000000011000100000000001011001100000100000001000000000001101010100000000101111000010000001000
10010010001000100000000000001001011000001000001001000100000001001001010100110010000100010100011001000
10001000000000101000010000000111111011100010100000100101010101111010000000101010000000000100100100000
01101010000000100110011101111101000001001011100000000000010110000110011000000000000100000000000011100
00001010001000010111000101000100001000000000001001010110010000011000001110000000011001100000011100000
00100010100111101111111001000000000010010001001010000011101010001001000010000011100000000100011000000
10000101100000100000000000010000111100000001010000000010000100001010011101100000001000001010000110010
00000111001000011001000000100000010000101100001000000100011110000010110000000011011100001010011011110
10000001000110010100000001010110010100100010100000000100001111000010110110001010000000000000100110000
00000000100001000000000001110010100001001010101000000100111000000001001000000011000100001110000000001
11011000110010101100011100010001000000010010000000011010010001100010000000000101001010000100000000010
00000001010001000100001000000010001011000100001000010100000000000011000000000100100001101000010000111
01001000100000110100100000010111001001100011000010001100000010011000001001001100111000000100000000110
10010000000000000000100000001001001100001010101100100000100000101000110010001101100000001011010100000
00100000000000000011000111001010001100000000101100001100000000000101000100000001100000000000111011101
00001000000010110010100000100000101010010000100010001000011100100000000000001100000010010100000111000
00000011101000010000001000011000000011000001100110010001001100110000000000000000000110000100000110000
00100110101000010100011000101000001000101011000100100000000000100000010110001010001010100100100000000
10100100000110000100010000110001001000001110100110000010000010000101001011010000000010100000001100000
00000000010100110100010110100111010101100000000010010100000001001000100000001100001100000000010001011
00100101011000101110110000010010000110100000100011001100000000100100010010000011000000001010000000001
00011100001100000000000010100100000100010010000001010110101011000000001100100000000101010000101001000
10011001000011011110000111100100000000001001010100111010100110000000010000111010100010101010010110000
11011001100111000010001010011011010100000001001000000100010001010001000101000000000100100001100101001
00010000100000100110100001001011010110010010000000100000001001101001011000011101000000000000000000010
00000000010010000110101101010100010100001011000011100100010000011000001010010010100000000000000001000
01110011010000001010000011110000001000110101001110101000011000100100011000111001001111100111010000000
01000110000110000100100101001000100000000000000110011010111010011101011100100000100100001101101000001
00000000000110000000000101001000000101010101110010000000110100000000010111000100010001101100101101111
10001000000100000001001110100101000000011000000100010000000000010000111011101000010100001000110001000
10010110010011000100000110000100010000000100011001001001011110100010101001000001000001100011011101001
00010010000101111100000000100000000000100001100000010000010100011010010010001000011100000100000010011
11011001001000010011001100011000100001000000100100000000110000010000010100010110010000100010100001001
00101011100101010101010000100010010110100000000000001101000100000100110001001001010000000110000001100
00100000110001011001010100010101000010010010000010100001010010110000100000011100000000010000100010001
00001010001000001101011010000001000101000010001100000000001001010000010001000101001000111011100000000
00001100101000100110100001010011010100000001001011000001000011101100100000000000001010111011101000011
00100001110001100001110000001000000100010001100101000111100110010011101011011000010011101100000000010
01110101000000000100010001110000101000010010000010010010101100000011110001100110011000111000000000100
00100001001000111110000000000010000000010000000001000000011100110100000000000010110100000000011000000
00001010010100101110000000110000010001000000000001000011100100100001000000101000110010000100010110000
00000011000100000000001000110000000010000000010100001001011000111000110010000001101101110100000000001
00000001011010101110101001000101010010100000000000000100100101001001000100000000100001010001100101100
00011100000101010000001100000000100110011100001001000110110000100001100000110000001001010010100011011
00000011100011011100100001000100110101010001000100111000010000100110010010101001000011010000000101000
01000000111000011000000100000000100100011011001000000100000010010010000000010010100011010000110000000
00000001000110100011011000000000010111000100000000011010001110100011001000001011011000010000010110001
00010000000000000000100011010001000001100000001010100000001110010100110011100000000001010000000010000
01011000101000101110010011001011001010011100010000000001100001001010100010101100000000010000100100001
10110001000010000001111100101111100000011101000111101000100111110010101000000010000110000110010000100
11000101010010000001000010001100110000101011101010101011101100000001011000100100010001010110000000000
00100001011000000110000100100010011000011100100001010010000001100000001100001110000010001000010001000
00010010000010100100111000010000000010001000000000100100000000101000000000000010010100000000010000010
10001000100011000000100000000001010001101100001100110110100010000001001000000001011000010000000011000
00000100110000000101010100000110010100001001001000100110001000011011101010001001100000010000111000001
01000000000001000010010001000001000100101100000100100000000111111010101001000001100010001100000000001
01010011100000000000011100001000000011010100000100000000001010010000100010000001110001000010000010100
01000000011001001000100011000001011100011000000100000100010000000000010000101001000101111010011000101
00011000010000010010000010000000000001010000101010011001001000100001000010100100000000010000011100010
00101000000100010100010001010100100101010000000001010010100010010000000000011100100010100000100000100
01001101001001000010010100000000010000101111010100010000001100001000011011000011000001010000110001001
00010000010001111100101000000011010001010000001010000100000011100100100100101111000010001000100000011
00100011001000000100010100001010000000101100101001100010101001001110010010000000000000000100001000000
01000010000100110011101010001010101000001000011010000010000000000110000000000010000010000100000010100
00001011100010000001001100000000000010001001010000000110000011000000010010010000000000111100001010000
01000010000000000000100000010001001100111001011010100001000000100011110100000000010000100100000111000
00110000100010000000110001010001000010000000000010100000001010000000100001000000011011101000001000101
00010000100110000100011100000010000000000010011001100101000101001101000000000011010100100001001010000
00010000000111011000000000000100110110100100000001010100100011001001000100100000001010001101001000000
00010000000100001001010000101101100000001001000001000101011100011010101100000000010010000100000111000
01010010010011100101000000010000101100100000100110001101101000100001011110100001000101011001010100100
00101000000000000100000000100000000100000110000001010011000101001010000101110100101100001001000010100
00010010000100000010110010111100010101000001101000010100101010011000101010000000000000000000000000101
10111000000001000010000000010101000110000100010000000000001000000000000011000001011011000100110000100
00010000010001010001001000010110001001010000000000000010010000000101101010110000001101001110001100001
00000010001000110110101000000000000000000000001000001000000001000000110100000001111010000000001100101
00001101001000000100000100000110000010010110010011001011000000010010111011001000100000010000110111100
00010000011110010011110100010011000100000010000000010010001111011010010000000001000000000010000001100
01000100010010000101000001000010001100111000011101000000000010010001111100000010001001000001001000101
01010000100000000010000000000010110000010010000010100010001010110101011111000011000101000010010000001
00000010001100001000101000111010011000000010000010100000100000010111001010011000110110000000110101001
11001001001001000001100100000100010100011000000000111000000110000010100110000010100000000001000000101
11000000000000011000001100111000000001100100010000000010000111000000000010110101000000011000000101000
