00100110000011100001001010000001000011001001100010001110011000000000011011100100100000001011001101000
10000110001101000001100000111000101011010111010110100101001100100000000000101000001101000010000000001
00000101000100101100110101100000000000001100010100100010001000000011001000100001001000110100010000000
00000110010100010010010000000000101110000010000000100000100001111010010101100011001101000100000000000
00011100000010100000100101100000100011000011010010011010000101000000100000100011000010011100101001000
00000001001001100000000010100000010000111011100000110001000111000010101010010100000010100001001001000
10100100000010111011110000110100001010100101010011110100000011100100010001000100000001000000001010000
00100101000001100101100100001100101000100101001000101100000100001000001000000010010000110010100010000
11100000000110101010000110110000000000000000000000000000100110010000000110101001011000000101000110100
10100001100110010000010100111010000000000011000110000000100000101001100010000000001000001100001101110
01100000000101011100001100000100000010001010001000001101100100000110100001000001101000010101000001000
00000010000100011100001100010101100001000001000000001001101001000000000100000010100000010011011100110
01001001100010001000010000100101000110111010000101001111000000011010010000110100001001010001000000000
00010010000000010001001000101001011000010010000000100001010100000110111001000000000111110000001010010
01010001100000110111000010000100101011011010001010000001010000000110001000001100000000100000010010100
00000001100100000000000001011100110001010100011001000100100000101110000111011101000100110000010010000
01110000100001001001000011000100000001011001000101000010001111110010000010100010010000000110111000000
00011010000000101000000000001000000110000100000100011000110000001110010111000010010010010100010100100
00000000000011110001000010000001010001011100000000110011000000000010000010000010000010001000010101001
01111011000001010100011011001010010010010000000101000000000000001000100100010010000010000100110001010
10010000000100000000000001000100000010000000100000110001000110011000011011000001100000100010000011010
00010000001010100101100110110000000110000010100001000100000000100000001000010100000000010110001000000
00000000000000110000010100001000000001001001000101000101000100000001000010000000010010001010110000100
10101000000000001000101000000100001000110101010001100000011000000100010100000000010010000000000100010
01011100000010101001010001100100010010001000000010000010000001111000100000100101001000001000001111001
10011001100100100100011001010011001000101000001011000110000010001000001000001000000000110000101000000
00010000000101010011110011000000001001001000110000111000001001000100100001011011000010011000010001100
00011001000000100000000100000000010100000100001100100100100111101000000001101010000100110110000000001
00000101010001001011100000000010010010000100100100001000000000010000010001001000100010000101001100010
01010010010101000100000100001010010100001000000101110010100100001110000010000000000010111000010010111
01100000011010101101100100010111100001001000110011000000001000100000001000000000010000101101100101010
11010100010001000101101010100010010010000001100110100010100001001000010010000100011000001000001100000
01010011001100100001101000100010011001100001101100000000000101110011100010101110100100000001010010000
00110001001100000000011000000010101000100000000000001000010000110011100110010010000001001100000000001
00111001010000100001100000110001101000001000111000000100000000010110000000000110101100011110000100001
00000100101111011100001000001011001011101001001001000000110100001000001000000011000001010000001010010
01101100001000000110010100100000000000101011000000001000010100010100101011100111101000110001001001000
00000010100001000000000100100000000110000000100100100001100100110010000100101000000101001001000010010
10000000000000001000010010100001001000001000100000000001000010000110000000000000000100100000100010000
10011110100000001000000100001000010110001010000001000110010000000111100110000010000110000001010100000
00010000010100010001001000011000000000001011000000000000000000010001000000110101000100000100011101100
00000100101000100000001001000000000000010001000100100010000010111001101010000100101001001011010000110
10010101000000000100001001110010011100100000011001101000011000010000000100001000100110001010001010000
11000010000010001001000100011011001000100000100000000100011000000001000000001110010100010000001000100
01011011000001010101101010001011000100100000110000000001000000001010100001000010011100001110010000010
01010001010001000011000110010101101001010001000010000000000010011010000101001000000011101001010101111
10010011001100001100000010000001001001011111001010000000000000000010000110010001100001000100100000100
00000001010110010100001101011110001100000000011110100101010011100110100000000010000000110000000011000
00000010101101011101000000011001101100001000110000001100101101010001000100000000001101001000001000000
10100001001001000011011000001100011001000110001101100100001001000101000111000000001100000110000001000
00101100010000001010010100000000000001000010000001011000100001000100000010000011010010100001010000100
10101010001111001110000001100100111101100011101000011110100000101010000000111000000000001100001001000
10001010100010011111001100000010010100000000001010000001100000000000100101001010010110000011011010000
01010000100001011000000001110000100000000000100110010001010001100011000100100001010010100001100000101
00001001111100000000010001000000101110000100100000000101111110000100000010000001100110110000001110100
00000010000001000100001000111001000010110101000001001100000001010000010000111000000001100010000000110
10001010100001000101010110000100111000000100100010100010000010010000000110100011000011001000000110011
10001101010110100010000000001010001010001111110110010101100100101101001110010100000011000000000000100
00001000010010001000000000100001101000001000000100000000000110000001010000000010000001111110101000010
00001010000100011000100100001000000011001000010010000000000110000001001100000001000010000001100010000
00100100000110010010000011000010001011100100110110010100100010001101000100100101001000101010000000001
01010101010001110010000000100000000001010101000100100010011000001010010011000000001010011011010000000
11000010010100111010010000100100000011111000000000000110011010000010110010010010000101001100011001111
11001110110001001000000000100100100101010000001000100000010000011010010110000001100001010000100001111
10000000101100010110000010100000100111001000011101101100001111011000011001000001000111010001100100010
00100000110000001001100100101010001000010010010010110000100001100000001010010100001001101000011101000
00100001000010101111000011000100100000000000000000000000010100000100010000110111001000101000100001000
00000010000101000000100001000001100011000100000000000100001010001000110010000000110011101000000010010
01100000010000000000000110101011001011000001100001000010001010000101110010000100010110000011000100111
10111001011110111000000100000011101001010010101000010010000000001000111000100001110000000010000000000
00011001000010100110010000000000001000110100000001001100000000001001000000011000011000000100010100000
00011100110010001001010000100000100010100100000001000110110011001000000100001010010000010000110000000
10000000001010100001100000011100000001010000110100100100001110101111000101000001011001000000001011011
10000001010011000100010000000000100000000000010011001100101000111000010000000110000010000010010100001
01001001010000000001000010010000111101100101110001000101000000001000101000000000010001001001001001010
11000000000000000001000000010100000000000001100110100000100110000000010001100100001101110000101100100
01000000000100100010101010110001010001010001000100000001000011011010000101000000000010010100001000010
00010010001001000001000100000000010001000001110000000000110000100100000000010001000010010000000001000
00010000110110010001000000000000000001000000010001000111100000110010001001000001010000000110011000110
11000000110011110100001101000001000101000011001000000000000011100001000110001000101010111000010000010
01001000000010100001110110100000001011011011001000000101001000001001010011000010110010100001000001000
01000000000010001100000010010000100001010011011001100101000011110010101001000000001100010000010000000
00000000000100100000001101100010000010010000110000000011000110000000111000000010111100000000000111101
01000000010000001011000001001010001100001110100010000000101100001000011000100001100001001000001011000
01001100000000000000000000010001001010000001000000001001101101000010000100110011001010000000001000010
00010001001010000100001111010011010111110000010011010000000000010000001000101001111111010000100000001
01000100101000100000000000000010000011000000000100001010000010100010001000101000010010100000001001001
01001000010000010110010000010010000101000100110000000000111000000010110111001000000010001000001100001
01001000100100011101011001000001000000000101100000011110010010001001010000010001100000000010001110010
00110101000011011000000110000100110010001001010100000001001100110110010110100001000000000010011000000
00000101101000011101000001000010000000100001000101000101010000001100011101100000000000010000100010000
10000000000000101010100000001100000011010001000001001001011111000100010001000001100011000110010010000
00011000011101000111000001001001000101000011011100001001101100100100000100000111000110000101101101000
00000000000000010000100111111000011010010000100000010110000110000010010001000110010000100100001100101
10011000010110000100000001001010101001010011010011001001000100000000100100000010011100101000010000000
10001000000000101111100011010100011110110010100000011100001000101001100010001000000100011001011010001
00000001000110010001000111101000000101100000000001000011000100000001010010101010000010010010010000111
00101001000000001100010111000101100101100111000100000000000100011011000000010101000110001000110011100
00100000001010100010000011111100000110000000010000011101010111110100100010000000001001100011000000011
00110110010011000010000001000010000101010000000000011010100000101000110010000000110000100000011100011
00001100000000001010100001010101000011000110000000100010011110001100111011000100011100111000001101011
